111111111111111111111111111111111111111111111111111111111111111111111111111111111111111111111111111111111111111111111111111111111111111111111111111111
122221211222112211222111212222222122211222222111111111111112222221111111111111211112122222222211222211222222122222122222222122222122221222111222112221
121121222212222122212122212111112221222211211222122222222212111121222222222221222221221222111212211222211212211112221111212212112121121212122212212121
121221221221211121122221112111111111111111211212122222222212222211222222222221221121211212222122111111221221222211112222211222122221122212221122211221
121212111121211221121223122122222222222221222112122222222212111221222222222221212221222121211221122211122121121222112111121111221111111111111111221211
121221222121222211121121222122222222222221212112122222222212221121222222222221221122212221222211221222111221122112222122222222211222222222222212122231
121122212211221112221212212122222222222221212122122222222211121121222222222221121311111111211122212112222212222111111111111112121222222222222212111211
121211111222111222122112112122222222222221122121122222222212221121222222222221222222122212211222111111111111111122222222222212121222222222222212221221
121222122112122211112112212122222222222221121122122222222212112221222222222221211211221211122212122222222222221122222222222212221222222222222212121121
121212221112221112212121212122222222222221122112122222222211222121222222222221222122212212221112122222222222221122222222222211121222222222222212122121
121221222221112221222221212122222222222221112222122222222211211221222222222221212121122222112222122222222222221122222222222212221222222222222212112221
122112212122212121221112212122222222222221221112111111111112212211222222222221221121111111111111122222222222221122222222222211111222222222222212121111
122221112211222211212222122122222222222221212212212211222122112111111111111111112221222222222221122222222222221122222222222212221222222222222212122221
121122211222111222212111121122222222222221212111221222212221222222222222212221222121222222222221122222222222221122222222222212121222222222222212122121
122211211111111111112122212122222222222221222222122112112111111111111111212122211221222222222221122222222222221122222222222212121222222222222212121121
121111212222222222212221222122222222222221213112212112122122222222222211222111111211222222222221122222222222221122222222222212121111111111111112122121
112221212222222222212211221122222222222221211221222112121122222222222212111222222231222222222221122222222222221111111111111112122112221222222212212121
112122212222222222212122121111111111111111222221111122122122222222222212112211111211222222222221122222222222221122222112211112212212122121211211212121
132211212222222222212212121121112222222111111121122221222122222222222212222122212211222222222221111111111111111121212222122211211212212121222122212121
112222112222222222211222122212222112111222122221221112112122222222222212111221221121222222222221222222211222222211211111121222211211212211212221211221
122112112222222222212112211212111212222212211121212222222122222222222212212211122221111111111111212211122211211222211222221111122222221222121111211211
121222112222222222211221212212222121111121222122211121111122222222222211122122112211222222112222211222221112221121221211112222111111111112122221221221
112212212222222222211211212111112121222212112111122212222122222222222211221112221222122112122111111111111112121122112213112112122222222212122122122121
112111211111111111111222212222112222211222112222221222112122222222222211212222121112221111221122222222222211122211112122222122122222222212121212212221
122122221111111111111111112212221111122122121111111111112122222222222212211112122221122222212122222222222212222122222122211121122222222212122121211121
121221122222122222222222212221111122222212121222222222212122222222222212112222111111111111122122222222222212112121111121212122122222222212112221212121
121111111112122222222222212122222221111222121222222222212122222222222212112122122222222211222122222222222212221221122212212112122222222212222111212221
121222211212122222222222211111111111111111221222222222212122222222222212222112122222222212212122222222222212111211221212112222122222222211111122211121
122211212212122222222222211222222222212222121222222222212111111111111111111222122222222212122122222222222212221221212222221111122222222212221121121221
111112212122122222222222211222222222212112221222222222212111111111122222112211122222222212121122222222222211122121221122112221122222222212122122122211
122222112221122222222222211222222222212221121222222222212122222222112112212112122222222212122122222222222211212121122211222122122222222212212212211221
121111221122122222222222211222222222212211221222222222212122222222122111122122122222222212112122222222222212212221122112211212122222222211211221222121
122222122222122222222222211222222222212222121222222222212122222222121222221121122222222212112111111111111112111112212122122212122222222211222122112121
122112211112122222222222211222222222212112121222222222212122222222122211112221122222222212112211222211222212221131212222122122111111111112112112112121
121111222221122222222222211222222222211222121222222222212122222222121121222122122222222212121222112122211212122222212112112121112221222212222122112121
112222122122122222222222211222222222211211121111111111112122222222122212211212122222222212121112222121211222211221211112222122212121211211221121122121
112112111112122222222222211222222222212211122222221122212122222222111212221212122222222212121111112211221111112212212221111111222121212212212222121221
112112122222122222222222211111111111112122211111112221222122222222122221112222122222222212122222221222121122222122122122122221111121212222122112221211
112112121112111111111111111221122222222121221222122112112122222222121122122122111111111112211221122112122121111221121222221122222121221111111111111211
122112221222222212222221222121121111211221122212121221222111111111112212221222222222112221211212112222112122222122122111111111112222121222222222111221
121111111111111122122212212222222221212211211112221222211222222221112121111111111112212122211221221111221112112112212122222222121121221222222222122121
121122222222222121121212111111111112212122222221112211122211111122222221222222222211221212121222212222112221112211212122222222121221211222222222121221
121122222222222112221212112222222212112212211111122111121111111111111111222222222212121222212211212112112122221212212122222222122212211222222222121211
122122222222222122121122112222222212221211222222222222121222222222222211222222222211221111211122222122222111121212222122222222121112121222222222121211
112122222222222121221221212222222212212211111111111112121222222222222211222222222211211111222211111111111122122231111122222222122122121222222222121211
112122222222222121211212212222222211212112222222221212221222222222222211222222222212212221111211222222221121221212221122222222112121221222222222122221
112122222222222122112212112222222211212212222222221221221222222222222211222222222212112122112211222222221221222112121122222222122122121222222222111121
112122222222222122222112212222222212221212222222221121121222222222222211222222222212222112222121222222221211212122122122222222122212121222222222112221
112122222222222121111121212222222212121212222222221122221222222222222211222222222211111111111121222222221211221121212122222222121122121111111111112111
112122222222222121122212212222222212211212222222221221111222222222222211222222222211222222221221222222221221121121222122222222112221222221222122212121
122122222222222122211222112222222211211212222222221212211222222222222211111111111111222222221211222222221121221121221122222222122121221121112221212121
121122222222222111211212112222222211211212222222221221221222222222222212222222113121222222221211222222221122222121212122222222121221121222221111212221
122111111111111122221212212222222211211212222222221122121222222222222212121211222221222222221221222222221221112122221122222222122112222131122222211221
112222221122222211222211211111111112212212222222221122221222222222222211221122212111222222221121222222221212221211121111111111112212112222211111222121
112211122121111211211111111111112222112112222222221221111222222222222211211121112221222222221121222222221212121212122112222112221212221122122211212121
112122211121121211212222222222212112112112222222221212221111111111111111212222221121222222221221222222221222122222112222112222122212112212121211211221
112221222222221212212222222222212122122112222222221212122122211122222221222112112221222222221211111111111111111211111111111111111122122212111211211211
121111111111111222112222222222211221121112222222221212122121222121122112221221222121222222221211222111222211221212222222222212222221221212221211211221
121222222222221211112222222222211211122211111111111122121122112221121222112211211221222222221211212222211222211212222222222212121112212211121212212121
121222222222221212212222222222211222111222211112222121322212211112121211122112211211111111111222211111122112112212222222222212121122132222121222122121
121222222222221221212222222222212112221111212222112122121211222212122212221222121222111221112211122222112112112112222222222212212221212111122112121221
121222222222221121212222222222211222121121212111212212121221111212211122121211121112221212222122212211222212212112222222222211222111222122212122221211
121222222222221122212222222222212211322221222222211222121112221211212221221221222112121222111221221212211211212212222222222211111111111121222111221221
121222222222221211212222222222212111121111111111111112122122121212222111112121212212112211111212121222111211211212222222222211222222222122121222122121
121222222222221211212222222222212222122122222222222212212221122212111122222121111222122112221212121111222212211212222222222211222222222112121212112121
121222222222221222212222222222212112212122222222222211111111111112112221211221222111121122121212121122211212112212222222222211222222222122112212212121
121222222222221211112222222222212111212122222222222211222222222132222112211212212112221221122212222221122212212111111111111111222222222121222221212121
121222222222221212211111111111112122212122222222222211222222222112111122221212112112112211111111111111121111212122222122222221222222222121213121212121
121222222222221221222211111111111221112122222222222211222222222112221222121222112222112112222222222222121221222111212211211121222222222122211212212121
121222222222221122211212222222211212122122222222222211222222222122112212111111111111112212222222222222122122111222211212212221222222222122122122221221
121222222222221211121212222222211212221122222222222211222222222121222112112222222222211212222222222222112112222121121222122111222222222121212121212211
121111111111111211222212222222212211112122222222222211222222222122112112112222222222212212222222222222112112212221112111221121222222222122212121212121
122221222222222212211112222222212121112122222222222211222222222112122112212222222222212112222222222222112222121111222111211221222222222112212121212211
121121211111212212122212222222212112222122222222222211222222222111121111212222222222212212222222222222121111222211211222212221222222222121222122121211
121121221111211212122112222222212212112122222222222211222222222122221222112222222222211212222222222222121222211221211211122121222222222121211212112211
122122122221221112112212222222211222112122222222222211111111111121112212212222222222212212222222222222122211112112222211221221111111111122212212212121
112212211121122212221212222222212111222122222222222212211112222121122121212222222222212112222222222222121112221112111112212222222221122222112121222121
122221222222211221122212222222212221112111111111111111212222112222222211212222222222212111111111111111122222122222122222112121111112221111222221111221
111111111111222122211212222222212121222222221112222213222111111111111211212222222222212222212222222111111111111112211121212212222222111122121223111121
112222222221212111211212222222212121211211112221221211211122222222221122212222222222211122212111221122222222221121222221211212111111222212223121222221
112222222221221221212211111111111121221212222122211221212122222222221221212222222222212221212122121122222222221221111112222212112222211221221121211221
112222222221121211222122212222222122121112111211222111212122222222221212211111111111112112212221121122222222221211111111111212212121122222212222212121
112222222221121221111221222112212221122222222222122222212122222222221211112211222222122212111223122122222222221211222222221221211221111111111111112121
112222222221122122122212111112122211111111111111121111122122222222221222221212212112111211222122212122222222221221222222221121222211222222222222212121
112222222221212112221122122212121212222222222221121221121122222222221211122222112112221221212212122122222222221121222222221221111121222222222222212221
112222222221212211122121121212212212222222222221221121222122222222221122211111222111122121211222121122222222221121222222221212221121222222222222212211
112222222221221222112121121221221112222222222221212222212122222222221121222222211222222221222111121122222222221221222222221211122221222222222222212121
111111111111211112112121122121122212222222222221221111122122222222221121111221111111111112112211122111111111111211222222221222122121222222222222212121
112211112222222222122223112121111212222222222221122222121122222222221221111121222222222212221222112112222222111211222222221112221221222222222222212121
122122222111111111111121222121222212222222222221211112221111111111111212222121222222222211121112112221211111222231222222221221112211222222222222212221
121221111122222222222112212122211212222222222221222221122112222112221212112121222222222211222112121121222222211211111111111212122121222222222222211221
122211111122222222222122112211122212222222222221221111112222112222121221122121222222222212212112121122122111112211122222222212221121222222222222212121
121112222122222222222121111111111211111111111111122222222221111111111122121121222222222212122112122112122221222112221122111122212221222222222222212121
122122112122222222222121222222221212221312221111111111111121222222222112122121222222222212211212212212211121211112112221122221121221222222222222212221
112212122122222222222121222222221211122222121222222222222121222222222112112221222222222212222211221211222111222212212121221111122211111111111111112111
121212121122222222222121222222221222211221221222222222222121222222222112112111222222222212112112222212112221121211212211211122211211112222111222212121
121221121122222222222121222222221111222122121222222222222121222222222112112221111111111112212222131222221121121222221222212221222212222112222211222121
122121121122222222222121222222221222112212121222222222222121222222222112221122211222212221221111111111111122211111111111222111211112111211111122111121
122221121122222222222121222222221212221222121222222222222121222222222122122111222211222121122112222222222111212222222221111122212222112221112222222221
121111221122222222222121222222221211121111121222222222222121222222222121212211111111111221212112222222222122212222222221211221112111222122221211122121
122122222111111111111121222222221211221222221222222222222121222222222122121221222222221211212212222222222121212222222221222212212122211122121212221221
112112112222222222221121222222221221211211111222222222222121222222222112121121222222221222221212222222222121212222222221221112122111122221221122112211
112212111111111111121121222222221121222222221222222222222121222222222112223121222222221212111212222222222121212222222221212222121222221112222221212121
121222112222222222122221222222221211111111111222222222222121222222222121121121222222221211222212222222222121212222222221212111221221111111111111212121
121111112222222222111121222222221212222222211222222222222121222222222121221121222222221212212112222222222121112222222221222111212121222222222221212121
122222212222222222112221222222221212222222211111111111111121222222222122211221222222221212122112222222222122212222222221121122212221222222222221212121
121111212222222222112111111111111212222222211222112222122221111111111121122221222222221212211112222222222121212222222221221121122121222222222221212121
121222212222222222112221122221122212222222211211222112212112221312221221121121222222221122122212222222222121212222222221212221221121222222222221212221
112211112222222222121122211121221212222222212212211121212111122222122112222211111111111121121212222222222121212222222221122111212121222222222221221121
112122212222222222121111211322211212222222212112122221221222212211112222111122222122212221121211111111111112212222222221221221222121222222222221212121
112221212222222222122221222121122212222222212212211212222211222122222111222221112221222111221221222111222212112222222221211122211121222222222221222121
122112212222222222121122112112221212222222212221213222111111111111111122211111111111111112212222212222211212111111111111222122112221222222222221221121
122212112222222222121212212222212212222222212121211211212222222222222121121222222222222212111111111111111212222222222111112211222121222222222221222221
121122111111111111121211221111212111111111111221221221212222222222222122221222222222222212122222222222221211121111212122221212211121222222222221211111
112221211222222222121222122222122111122221122222122122212222222222222111121222222222222212122222222222221221221222211121121212122211222222222221212211
112121122211211112121212211112221222211122221112112211212222222222222122221222222222222212122222222222221122221111122221121212221221222222222221221211
112122121121222221221211222211111211222211212122221212212222222222222121111222222222222212122222222222221211121222121112222212222121111111111111121211
122111122221112112212212111222111212211222212221121212112222222222222122111222222222222212122222222222221221121212221111111111111121122211221111122231
121222111211222122112112221121222212121111111111111211112222222222222112221222222222222212122222222222221121121221121222222222212221121222212222211211
122212212212211121212122112221211112221222222222221222212222222222222121121222222222222212122222222222221121121122121222222222212111221221122112211211
121111222122122221212121222122212222221222222222221221212222222222222121221222222222222212122222222222221121122212211222222222212211211211221212122211
122222111221121111212221211111111111121222222222221212212222222222222121211222222222222212122222222222221122211221211222222222212222111211211212121121
112111222212221222212112212222222222121222222222221112112222222222222121221222222222222212111111111111111122212121221222222222212112122212212212221121
111222212212112211222122112222222222121222222222221222111111111111111121121222222222222212122212222222222221222121121222222222212122121112122111111221
122211112122112221111121212222222222121222222222221211222211211112222221221111111111111112121222111111211111211121221222222222211121222212212222122221
121122122121222112212221212222222222121222222222221222211222122222121111212222222222222212212111222111221222122221211222222222212221211221222212112121
121221221121211112112111212222222222121222222222221111122112121121212221212121111111111111222122212222121212121111211222222222212111222122111212122121
121211212121222212112122212222222222121111111111111111112212121121222121211221122222222221221221131112122212121221211222222222212122112212222122121121
121222212122111212112211212222222222122122221122221222212212221121221121222222122222222221121212222212211212222211221222222222212212222221112221221221
122112112212111222121212212222222222112221121121212211222121112222222121111112122222222221121221221221221221112111121222222222211211111111111212212211
122212211212221122221212112222222222121112122121212112112111111111111122222122122222222221222121212121121112221222221111111111111212222222212212111111
121211222211121221112212212222222222121222112211222222122122222222222111121121122222222221211221212221122222122211112222111112222212222222212122122221
121221122122221112222121211111111111112212221221221112121122222222222122122221122222222221222211221211211111111111111112222212111212222222212121221121
121122212121111222111122222222222222212112212121211112121122222222222121111111122222222221111121121222212212222222222211221222211212222222212122212221
122111211122212211111111111121112111211111222122122221122122222222222121222222122222222221222212223111221212222222222211222111221212222222212111122121
112221222221222212222222221221222122222222212112121121112122222222222122211112122222222221211212121122121212222222222212211222121212222222212222221121
121122111112111212222222221211211111111111122112221122222122222222222121222212111111111111221222121221221212222222222211122212121212222222211111112121
121111111111111112222222221221211222222222121111111111112122222222222121111212222122212222122111221212212212222222222212221122122112222222211222222121
121222222222222112222222221121221222222222121222222221212122222222222121222211112121221212111222212212122212222222222212111122122212222222212211111121
121222222222222112222222221221121222222222121222222221212122222222222112211122122221122212122211112222121212222222222212122212121212222222212112222221
121222222222222112222222221212221222222222121222222221212122222222222112112222221112211112221112212111121212222222222212221212212212222222212112111111
121222222222222112222222221212111222222222121222222221222122222222222112112111112111222111112221212221221212222222222212112211222111111111112112212221
121222222222222112222222221212211222222222121222222221211111111111111132221222221222212222112122231121211212222222222212122122111222222112222121221121
121222222222222112222222221211221222222222121222222221222212222222122112122112121212221112212111212221211212222222222211221222211211112222122221122121
121222222222222112222222221221121222222222121222222221111211121112221222212222121122121111222112221121212212222222222211211211212211111212113111212121
121222222222222112222222221121121222222222121222222221221222122121221211121111322212122221121222121122212111111111111111213222122112222212211112212121
121222222222222112222222221121121111111111121222222221211112212121121122211222121212211122122111221111122112221122222212211221221122111121122222112121
121222222222222111111111111221122211222122211111111111222211212122122121212212111211211212211222112221121222122221111212122121212121222211221112212221
121111111111111122222222222222211222212221222222222222211222222112222221222122222211222211222212222122222211211112222222112222222122211222222221222221
111111111111111111111111111111111111111111111111111111111111111111111111111111111111111111111111111111111111111111111111111111111111111111111111111111
