111111111111111111111111111111111111111111111111111111111111111111111111111111111111111111111111111111111111111111111111111111111111111111111111111111
122222222112222112111122222122211222112221111111111111122222122222221112222122222111222122111122222222211222113122222122111111111112222222221222222221
121122112112112221222221221121222212122122222222222222121221121221122212112221112222212112222121122111122212222221112212122222222122112211121122111121
112221212132221121211111211221221112121112222222222222112211121212211212111111111111112111212122122222221121112112221212122222222111222122223112121121
122111222112111212211111222211212212122212122222222222122122221212111212122222222222112221212112121111222211222112121212122222222122211121121222122221
121222221112222122122221121122212222121212222222222222121221112212222222122222222222121121212222212222111122211122112212122222222121122211221211111111
122112112221122221121122122121112111122122122222222222122212212122211122122222222222122121221113122112221121112221122112122222222121221211212212222221
112112122122121111122212211221122122112121122222222222121122112121121112122222222222112121112221221111122121222121221222122222222122111211212222111121
122112221212121222111211212212121112212121122222222222121121122122112221122222222222112122222122212222222122121121212212122222222222211212212111122121
121221112212111212222211222112122221222121122222222222121221121112212122122222222222112121111111111112112212122211212112122222222221211212112122221221
121121222122221211111111111112211121221221122222222222121212122221122112122222222222122121222222222222211212211222222112122222222121211212112221221211
122122212221122211222222222211211221211212111211111111122222111121221222122222222222121121222222222222211221221111111222122222222111211212121121112211
112122111111111211222222222211222211122212111222211111111111111122212112111211112111121221222222222222212121122222211211112111112122211222121221122221
112121122222222211222222222212211112221222221212112222222222221221112212212222222222222211222222222222212122111111211211222112222221112112122212221121
112121122222222211222222222212112222112113121212112222222222221211111221211111111111111121222222222222212112222222212222212122122112221122122122211221
122122122222222211222222222212122121222111122112212222222222221222222212212222222222222121222222222222212221111211111111112111222212122121221221212211
121112122222222211222222222212212121221222112111212222222222221121111212112222222222222122222222222222212112122222222222112222111212212221212211122111
122212122222222211222222222211212122122212112122212222222222221221222112112222222222222121222222222222212221122222222222111112112211211111112122121221
121212122222222211222222222212212212211112212121222222222222221212212222112222222222222121222222222222212121122222222222122222222122222222222112122121
121221122222222211222222222212122211211121222111212222222222221212121111112222222222222121111111111111111221122222222222121111111111121111111222212121
121122122222222211222222222212211221222211212222212222222222221212122222212222222222222111111111111112221211122222222222121222222222222221112211212121
122212111111111111222222222211212111121222112112212222222222221112112211212222222222222112222222222212122222122222222222121222222222222122222112212121
121122122222111221222222222211212222212112122111212222222222222222112112212222222222222112222222222222111312222222222222121222222222222122111222212221
121221121121222121112111111111211121222112111222112222222222221211222112112222222222222112222222222212222112122222222222121222222222222121221211221121
111212221122212222222222222212212221122212222212212222222222221212212221212222222222222112222222222212112221111111211111121222222222222122121221121221
122211111111111111112112212122122112211211111121211111111111111221111122112222222222222112222222222212111122211122222112221222222222222112221122211211
121121222222222222212212122121221112112222221121222221213112222122222212212222222222222112222222222212122211222221211222111222222222222122112211221211
122211222222222222211122111222212222222111122222122121222222112121111211212222222222222112222222222212121222111111222211221222222222222121122211121221
121221222222222222212221222212111111111111111112121121122111212122122212211112111111111112222222222212122111111111111111121111111111111122121212222121
121121222222222222222121211112222222222222122112121122121222212211221112112222222221122112222222222212212111222222222212222111111111111112221212112121
121221222222222222212121221112222222222222112222221222221121111222211222212111112122212111111111221111212221222222222212122122222222222211111212111221
112211222222222222212122122212222222222222111111111112111121222112121211222222212211222222122222221222211121222222222222121122222222222212222212122211
122111222222222222212212211212222222222222112222222222222221212112122211111111112211211112211211122211111121222222222212121122222222222222111112221121
121221222222222222212221221212222222222222112222222222222122212221222111222222222222122221122222111122222221222222222222122122222222222211111111111121
122121111111111111212121112212222222222222112222222222222121122121211221222222221212221122221312211222211221222222222212212122222222222211222222222121
112121111122222211222122222112222222222222112222222222222121221113222122222222221111111111111111222121212121222222222211112122222222222211222222222121
112121222221211122212111211112222222222222112222222222222121212221211222222222221122222222222221112121212122222222222212222122222222222211222222222221
112122211111222221212111222212222222222222112222222222222121222121222221222222221122222222222221122121212221222222222212112122222222222211222222222121
112121122221111112221222111212222222222222112222222222222121111122111121222222221122222222222222221112212111222222222212112122222222222211222222222121
132212221121222212112212222112222222222222112222222222222121122212222221222222221122222222222221212222122111222222222212221122222222222211222222222121
112222121121211221222121112212222222222222112222222222222112221221111111222222221122222222222221212111121221222222222211121122222222222211222222222121
122111221122222122211122221211111111111111112222222222222122111122122211222222221122222222222221222121122121111111121111221111111111111111222222222121
121222111111112111122221121212222122222222212222222222222122222212221211222222221122222222222221121122222222222212222222222121222221122221222222222121
122212122222222211221222212222112121212111111111111111112121111111111211222222221122222222222221221111121131111221211221112122211122121211222222222221
111122122222222212212211212111122111212122222222222222222221222222112231222222221122222222222221212222212222222121211122212212112212221211222222222121
122121122222222212112121212211221222212121111111121111111112211212222211111111111111111122111111212111221121211121222211211212222111111211222222222121
121121122222222212122121221222121221211221122222222222221122112221111222222221222213111222221222112122122211212221111122231211221222112211112111111121
122221122222222212121122122112122121122211221222222222221221212111111111111122111222222211112212222112111211212112222212211212112212112122222212212221
122111122222222211221212112112212221121112211212222222221211212122222222222112222112112111222221111222211211222222111222122221222122222221111211212121
121222222222222212212122112121221112222122221212222222222211212122222222222121112212122122211111111111211222113122111112111122211111111121112213222121
121112122222222212112221112221122221112111112212222222221221222222222222222121111211121221112222222221222112221212122222222111121222222222222121211121
122222111111111112121122221222211122222222112112222222221121221122222222222222221222221212112222222222212221121222122222222122221222222222212121211121
111112112221122222121111221211111111112112112112222222221122112122222222222122122111121212212222222221212111122121122222222112221222222222212121212221
122122122122221211222222212212222222222212212212222222221112222122222222222122212112221221212222222221211222212122122222222112121222222222212122212121
122221121111111221122112212112222222222211211212222222221221221122222222222121212221121121212222222221222211212211122222222122121222222222212211112121
121112222222222122121221212222222222222211222211111111111211121122222222222222111121221221222222222221211122221222122222222221221222222222211222112121
121111121111111112121121211222222222222222121222211222122222121122222222222112122122112211212222222221222121111112122222222122121222222222212112112121
122222222222222212122122212212222222222212222111222212211312122111111111111112121212122111212222222221212122222112122222222112121222222222212122112121
121222222222222212122211112112222222222211111111111111221122212222111222122222222212222222212222222221221111112122122222222112121222222222212121222111
121222222222222212121221112212222222222211222222222221122221221112222212221111111112111111212222222221112221112121111111111122121121111111112121112221
121222222222222212122122222212222222222211222222222221211121111111111112111222222222221221212222222221122122212122111222211221121122222211122122211121
121222222222222222212211111212222222222211222222222221212221222222222212211222222222221212211111112111121211212212222111222212121221211212221111222221
121222222222222211211111222112222222222211222222222221222111222222222211211222222222221222122222222112221212222121212222112112221211211222121222111121
121222222222222212212221212212222222222211222222222221211121222222222212211222222222221212211112112112111222111112211112112211121221222111121212222221
121222222222222212112121211212222222222211222222222222212221222222222212111222222222221121212222112222122211222212222122122222122121112122121221111111
121112111111111112222122211212222222222211222222222221222121222222222212221222222222221221222111111111112111211221211221121112112122112112221122122211
121222211111111112111111122211111111111111222222222221111221222222222211121222222222221212212122222222222221212221212212122122122112112211212212212221
122122112222222212112221221212221133111221122111111111221211222222222212221222222222221222121122222222222221221122112112121221222212121221221211212121
112112212222222212222111212212122222222112122221121111122211222222222212121222222222221211122122222222222221121212222112221211111212122121112222212121
112111212222222211211222212122111222112122121122212222111122222222222211221222222222221211112122222222222221121211111212211212221212112122212111122121
112221212222222212212211112211122212112221122211212112222121222222222211211222222222221212222122222222222221121212221222121222121122222111222122221221
121122212222222211122122221221121121221223111221212211112221222222222211211222222222221222122122222222222221221222121221223111121221121111111121111211
122212212222222212221121121122221122211121222121221221221221222222222211221222222222221111212122222222222221212221121212221222121212122222222221221211
121221212222222222112221122111112221222121212122122121121121222222222212121111111111111222122122222222222221211111122222122212122222122222222222121211
121121212222222212112112212222112112112121122212112221121121121111111211221222111222111112221122222222222221222212221111111111111111122222222112121221
112221212222222212212212221112212112122122221122111111221221222222221222112212222112122221112122222222222221211212112212222222222221122222222112121121
122121212222222211211212122211212222121221112221222222212212211222121212222121112222221122222122222222222221211212211212222222222221122222222112121221
121212211112111112212212211212211112122212222111211211212122111212121211112111111111112211122122222222222221122211212222222222222221122222222132221211
122212122122211122122111112212131212111112111112211222112111222122122211222222222221111222212122222222222222221111222212222222222221122222222112112231
121112212121222221221222212122222212211112122222222112222222212221211121222222222221222122122111111111111111212222111212222222222221122222222112122211
122221212221121111212211222121121111222212111111111111111112111111111222222222222221212221221222221122222122222112112212222222222221111112111122121221
121122212111121222222122222122122122121212122222222222221212222222221211222222222221221121211212121222111121311222312112222222222221222222121221121121
122111121222122111111111111112112221122122122222222222221212222222221211222222222221222211211212122212122221111112112212222222222221211112121211221121
112122122212112212222222222222211211112121122222222222221212222222221221222222222221211221222112111111221112222222111212222222222221221112122211211121
122112121212111212222222222212222122222122122222222222221222222222221121222222222221221122112132222122222212111111222212222222222221121222211112212221
121122221212222212222222222212112121111212122222222222221212222222221121222222222221121212212212112221211112111112212112222222222221121211222222122111
121121112211112222222222222212122122122122122222222222221212222222221121222222222221221221211221111112212222122221122112222222222221121221111111112111
122121222112221212222222222211222212221121122222222222221212222222221121222222222221222121221122222212112111121122121212222222222221122121222222222211
112112211222121222222222222211211122111223122222222222221212222222221221111111111111211221121111111212112111221112122211111111111111212121222222222211
112112122211112212222222222211221121222221122222222222222212222222222211221222222222222212221222111212212222212222111221222222122222112211222222222211
112212121112222112222222222212222121211122122222222222221211111112111222212211111111111122112212222211221111122111222121122112111212121221222222222211
121222122122111211111211111112112221221112122222222222221222222222222222112112222222222121222111111111111111121222122122221212122212221121222222222211
121111212121222212222221211112211112121222122222222222221111111111111212222112222222222122211221122222222222121212221112111222221121222221222222222211
122222222222212221112122122221221111221211122222222222221122222222222211111212222222222111122121122222222222121221122212211111111112131122222222222211
121211111111211122112112121122122221211222111111111111111122222222221212222212222222222121112223122222222222122122111221212222222212222121222222222211
121212222222222112222311121112112121211112222112221222222122222222221212112112222222222122211223122222222222112112211122222222222211221121222222222211
122112222222222121112122221222112211212221112222122112111122222222221221112212222222222121222221122222222222132221122211212222222211212221222222222211
112112222222222121121221112211221122212111112111112132222122222222221122211212222222222221221122122222222222112121221212222222222212212111222222222211
122112222222222122221212212122122221122122222222212212112122222222221111211212222222222121212222122222222222222112211221112222222212112121222222222211
121212222222222121221221212112222112221122222222211212112122222222221221212222222222222121211112122222222222121112122122112222222212222121222222222211
122212222222222122121121222211221111211122222222211212112122222222221211222111111111111121212221122222222222122222212112112222222212111121111121112111
111212222222222112121122111222212222222122222222211212212122222222221221112122212211111121212121111111111111122111222112112222222212222221222221112221
121222222222222112122212221111111111112122222222212211112122222222221222212221221222222221222122122212222221221222111222312222222211112112212122212121
122212222222222112111211121222222221222122222222212122222111111111111211221111121112111111121112221222111121211212122212112222222211112212122111212121
122112222222222112221222221222222221212122222222212121122211111111111111121122221222222221221222112111222121212212121112112222222212221221121221211221
121111111111121111122111121222222221112122222222212122111212222222222222122211211222222221211211221122211121212122121222112222222222122121121121211211
121222212221122221112222211222222221222122222222212212222112222222222222121211211222222221212212212221222122112121221211212222222212111221322122221211
111211222122221122212211221222222221212122222222211212112112222222222222121221211222222221212122122112112212122122211222211111111112112211122211121221
122212111211112211221111121222222221212122222222222212212212222222222222121121211222222221122121122221311212221111111211111111122212112112221222121121
121112122222221211121122221222222221221122222222212122211212222222222222112221221222222221221122221112222211112221222222222222121222112212111112122221
121212221112212222121221121222222221222111111111112121122212222222222222112121122222222221212222112222212222222121222222222222121111221211222222111221
121222222221222112121211111222222221212222111122122112221212222222222222122112221222222221211111222111221311111221222222222222222222121211211111122121
121111111111112112221212221111221111221221222212221222111212222222222222121122111222222221222222122222111122221211222222222222122112222222212222221221
121222222222222212112222122122222111122122211222211122122212222222222222121121221222222221221112121112222221121221222222222222111111111111122121112211
121222222222222212122111112211212222212111122111122222121112222222222222121121121222222221211122111111211122122111222222222222112222222222121121222121
121222222222222212111222211211211111122112222222221112121111111111111211122221221111111111212222122222222112112221222222222222112222222222121221211211
121222222222222212122211222211212222221122111121112221221222211222111221122111212222122213122112122222222112111121222222222222112222222222112221211221
121222222222222212221111112111222111112121222121212122212211222112222122222222222112211222221111122222222112122121222222222222112222222222122121211121
121222222222222211221222222221211221222222212121221111122122112211212111121111111221222112212222122222222132221221222222222222112222222222121221222121
121222222222222212121222222221211222211112111121122222221212111221212122222222221211112221212112122222222112112221222222222222112222222222121111112121
121222222222222212221222222221212211222121222121111111111112222122212122222222221222111121222112222222222122122121111111111111112222222222121222222221
121111111111211112211222222221212221112211212121222222222212112211122122222222221212222121112212122222222121121122122112222221212222222222122211111111
122222212222221222121222222221221122111122212221222222222222221222221122222222221212212122212122222222222112221222212222121122212222222222221122212211
122111221121121211221222222221122211222221121221222222222211122111111122222222221122112211212121122222222112111111212211122111112211111111121121211211
122222112221221222221222222221211221211111121122222222222211212122222122222222221121121212212121122222222112122222122112212222222222222221121221211211
121211112111211111121222222221222122212222221121222222222212212121212122222222221221221212221121111111111112221112222212121111211111111122222211222211
121222222221222221121222222221122111122122111222222222222212112212212122222222221212212212112221122122221111121111111222222222222222211111121111111111
121111111111111122211222222221121222121212122211222222222212211212112222222222221221222122122111222121122212222222221112111222222222211222222222222211
121222222222222111211222222221222212221222121121222222222211221221222122222222221121211121221221212121211212222222221212211222222222211222222222222211
121222222222222112211222222221212211112221221122222222222211122121212122222222221322112221212122221122211212222222221211211222222222211222222222222211
121222222222222112121111111111221122211112211121111111111112221121221122222222221122222111212222122222212212222222221212211222222222211222222222222211
121222222222222112122222112221122221222222222221222222111222111221121122222222221221111221211121111111112112222222221222221222222222211222222222222211
121222222222222112222122222122212111111111111112212112221212222212221121111112111211222122212222222222112112222222221211121222222222211222222222222211
121222222222222121131221111211212122222222222112112111122211111122122222211222121222212211212222222222122112222222221212211222222222211222222222222211
121222222222222111111111111111212122222222222112221222211121222111121111222212221111121211212222222222121222222222222211221222222222211222222222222211
121222222222222112222222222221212122222222222121121211222222212222221111111111211122221212212222222222122212222222221222121222222222211222222222222211
121222222222222112222222222222221122222222222121221221111111111221221222222222222221212212112222222222122112222222221112221222222222211222222222222211
121222222222222112222222222221121122222222222121212122222222221212121222222222222112212122112222222222112112222222222221121222222222211222222222222211
121222222222222112222222222221121122222222222122212121222222221212221222222222222112112212212222222222112112222222221212121222222222211222222222222211
121111111212112112222222222221221122222222222111212221222222221211111222222222222132221211212222222222112211111111111212221111211111111222222222222211
121122222222212212222222222221212122222222222112212111222222221222211222222222222112121212212222222222122222221111212222212222221222121211111111111211
122121112121211212222222222221222122222222222112112121222222221221221222222222222112122212112222222222121111121222212111122121122212122222212222222211
112212221121211212222222222221221122222222222122112221222222221222121222222222222112211112211111122111122221222211122112221221211122111221221221111211
121212122221211212222222222221121122222222222121111111222222222211221222222222222121222122222222222122212111212111221221121211211121112212121212211211
121212111112212212222222222221122122222222222222222211222222221211211111111111211121112121111111211221212122212122212122221221222221222122121221222211
122212222112212112222222222221212122222222222111111211222222221213222112222112221122212121222211222212212121121121112221111122122111211121122121112121
121122212221212111111122111111212111111111111112221211222222221221212212112122122221222111211211111112122122122221221112222112121222212221112221122121
121111111121222212221122221222212221222222112222121211222222221121221122211221111112111122212212222112121212122111121222212222121112212112221111121221
122222222221111222122221122211221122211112222111122211111111111122122221222222222222222221122222112222122212222222222211221111222222122222122222222211
111111111111111111111111111111111111111111111111111111111111111111111111111111111111111111111111111111111111111111111111111111111111111111111111111111
