111111111111111111111111111111
122221222222222222222211222224
142212211111211111141211211214
112122121222222222211221224211
122121121222222222242121142211
121122224222222222242421222221
124111111222222222212122241121
124222121225222222222211121121
122212121222222222211222422224
121112121222222222213224222144
121222221222222222211222214221
121111111211111414112212122221
122222222241111111111122112121
122111221221222222222424122211
121222422121222222222221221211
122122212121222222222222124221
112121212211222222222112421121
112414221244222222222422122121
142222212214222222222121111221
121221212121222222222224222224
121124212221222222252122211121
124122112211222222222114441221
122212121224111411141442222214
122112121121112222112222411121
112122122122222112122111222221
122121212242411222121141242221
121221222122111211124222122121
122221112121222111222212421121
111122222122212222211122221221
111111111111111111111111111111
