111111111111111111111111111111111111111111111111111111111111111111111111111111111111111111111111111111111111111111111111111111111111111111111111111111
122111111111112222222122222222211221122222221122222112222221222122222221122222212211112222221222212212222222122222122211122222222211112222222222211221
112122222222212112211221112111222121221112122211212212122121221221122121121111222122212112121121221212121112211212211222221112121222221111221111222121
112122222222222221212212212222112122222122111221211221212122122211221221221111122221221222122221212222121222222211222112212221322111122221122222112221
122122222222211212212112111112212211111121221222211122122112122122211212212222211111121211111111212111121111112111112221112122122211111122112212121121
121122222222212212112112222221221222222221122211122212121222121121121222122111222212221222222222122112221222222222211121122112121222211112221112121121
122122222222211122122121111122121112111111111122221112122121121221122111111111111212112211111112221112121222222222212223121212212111222221122212122221
112122222222212221221122222212122222222222222121122212212121121212112112222222221212122222222221112222121222222222222121221211221222111121111222121111
122122222222212112212212111222121222222222222121211211222122211211222312222222221212211111111111112111121222222222211222212221121212222122222111122121
121122222222212122112122211112121222222222222121211222111111212211212112222222221211211222222222122122211222222222211211122122222211112211112211212121
121111111121112221212221222221121222222222222121212121111222222122212212222222221212211222222222121121221222222222211221111111111122221222211222122121
122221222222222211222111211121221222222222222122222122222211111111111212222222221222121222222222122122122222222222211121222222222121122111222112121221
121111211111111111111111222121211222222222222112111111111112222222212212222222221221221222222222122222121222222222212221222222222121112222112222122121
122221221222122222222212211221211222222222222122122222222212222222222112222222221211211222222222121111221222222222212111222222222122211211221111212121
122122122212122222222212112221211222222222222121221111111212222222212112222222222221221222222222122122211222222222212111222222222121221222122222122121
121121211122122222222212112121211222222222222112212221222212222222212212222222221121121222222222111221121111211111112221222222222221122112122112222121
121122221121122222222211222121221111111111111132221121212212222222211212222222221122221222222222122212221112221222221121222222222112212112222221112221
121221121221122222222211211121122222122222122212112221211212222222212212222222221111222222222222121122112222122211122221222222222112112211211111111121
121211112212122222222211212122111112121221121222222111212212222222212112111111111222121222222222121121222111111111111211222222222132221211222222222121
111212222112122222222211212212112212121122222113121222212112222222212222211222221212221222222222121222211212222222221221112111111112111211222222222121
122212111222122222222212211212212112122111111111121211122112222222212111211211211211111222222222121211211222222222221111222222112212222211222222222121
121112221211122222222212112211222112112122222222121212221212222222211222212211222213121111111111122131222222222222221222111212212122111121222222222121
122221121221122222222212212122211222312122222222112212112212222222212212112121111122222221112221212222111212222222221212221221122222112221222222222121
122121122122222222222211212221112212112122222222222112112112222222212122122122222112111121222121222122221212222222221221122122221112222121222222222121
121222212112122222222212212112212112212122222222121122222112222222212111221212112222122222211121112121121212222222221121112121111111111221222222222121
121211122122122222222222122122112122122122222222121222111211111111112222221212121121111111111122212212121112222222221122212121222222221211222222222121
121212221121111111111112122221122121121122222222122112211222222222111221122222121222222222221211211222122212222222221211212211222222221221222222222221
121212111222122222122222211211221221122122222222112121212221111112222112221311121222222222221212212122111212222222221212211211222222221121222222222121
121222222212221112211111211221212212212122222222122122212111222212112211111131221222222222221122112212212212222222221212111211222222221121222222222121
121111111111111121222211222112212112122122222222121211122221211212111222112222221222222222221121221211212111111111111222221222222222221221222222222121
121212222222222122111212211122212122121122222222121212222112212212222112212121121222222222221221211222212222211221222211121121222222221211222222222121
122212222222222112111212112221212121122112211111121222112212122111112221221122211222222222221212212211111111222122211122212221222222221221111111211121
111212222222222122221222122112122122212122222222222212211122121222221111121212221222222222221221212112221222112222112221212121222222221121222122222211
112212222222222121122122121222121211212211111121111122212221122211122222221212121222222222221121222122122112221111112111212121222222221221212121221211
112112222222222222211112122122122122211212222222222121122121111111111111112221121222222222221122121221122221121222221222212121222222221211212112212211
112212222222222121212222112121122221111212222222222112221121222222222222122122221112111111111212122212221122222211122212212211111121111212212222122221
121222222222222121222111222122221121222212222222222122111121222222222222122111222122222112222122111111111111131211111111111212222122221222111111111111
122212222222222122111222211111111211211112222222222121222221222222222222112111112121212212112221212222222212111212222222212212112121122112122222222211
122112222222222111222122112221222122221212222222222222111111222222222222112122212121221112121112112222222212222212222222212122212221222212122222222211
111111111112111122212221222122212221122212222222222112111111222222222222112121211221122222122222222222222212211112222222212211211111211112122222222211
122221211122122221122112211111111111111112222222222112122222222222222222112221221212211112111111212222222212112212222222211221221222122222122222222211
121122122221221212121122111122222222222112222222222132221121222222222222122111121211212222222221212222222212122212222222212122122212221111122222222211
121122221221212212221121222122222222222112222222222112112221222222222222121212221212222222222221212222222212221212222222212112122221211222122222222211
122121112122112122111121212122222222222112222222222112111122222222222222121212111212112222222221222222222211111212222222212212121111222112222222222211
122212212212222121212221122222222222222112222222222122122221222222222222222212122212212222222221212222222211222222222222211212211222112222222222222211
121221212221111122212112221122222222222112222222222111221111222222222222111212221121212222222221211112111111211112222222212221212212121112122222222211
111121212121111112212212121122222222222112222222222122212211222222222222122211112222212222222221222212222221221112222222222111222122122212122222222211
122221222122222221221212122122222222222111211211111121122221222222222222121111122112112222222221211122111223122211111111112222111221121112122222222211
121121112111111121121212212122222222222122211222122221121121111111121111122122211222112222222221222121222221111222111312221221222212222222112111111111
122121222222222122121211122222222222222121211212211212121122222122222222212221212221111111111111112122122122221211222222122211211111111111112222221221
112121222222222112121222121111112121111121212211211212122211221221112112211112212121222222122222222212121211121221212211221122231222222222212121122221
112211222222222112121112221122212221112221222121211212111211212212221112121122112211211212112212113122121222222121122111112221211222222222211221111121
121211222222222122121212112221222122222112111121212212222211222112122222122221221212212212222132211121122111212122221222222111221222222222212212221121
122231222222222121122212212111111111121111121221222111111111111112111121222112121222112121111222122221212222122111212211111222121222222222212122121121
112231222222222222222221212112222222222222222211112122222222222212111221211222221211112211222121121111211112211222212122221212121222222222212121221221
122211222222222221111121212212222222222222111222222122222222222212222112211213122222221222212121221222222221222211122122122112121222222222212121211111
121211222222222121122211221222222222222222111111112122222222222212112212121221111111111112112212211212111111111122221122212222121222222222212221222211
121221222222222221121211221212222222222222122222112122222222222212211212212221222222222212121222122212222222222112211221211221221222222222211111111221
121121111111111121221222211212222222222222121112221122222222222211211221212121222222222212221111221212222222222122111211221112211222222222211222222121
122211222122212221212111122212222222222222121121121122222222222212211221221222222222222211222112212212222222222121221212121222121222222222211211212221
121122212221221121212111121112222222222222122223121122222222222222111212121211222222222212112112131112222222222121121212121211221222222222212212211121
122221111112122121212222122222222222222222111121221122222222222212221221221221222222222211222132222112222222222121122222122222221222222222212122221121
121111222222312121211112211212222222222222112221212122222222222211122121212121222222222211211212122212222222222121111111111111121221211111112111112221
122221211112112211212222121212222222222222112111221122222222222212222121221221222222222211221222121212222222222121222222222221221222211112212222212111
111121212222221222222122221212222222222222112122122122222222222212111121122121222222222222122112211212222222222121222222222221212121222222112111212221
111221112111211111111111221211111111111111112212212111111111112111222222212121222222222211212221211212222222222121222222222221222122111111222221221111
122212222122222222222221121222222222112222211221212221222221122222211131212121222222222212212112212212222222222121222222222221122212222211213111122221
121122122122222222222221221221211111222111222121211121221122121111111111212121222222222212112221112111111111111121222222222221211221111222211222111121
122221212222222222222221212121212222211111122222222121222212221222222221122121111111111112211122222122212221222221222222222221221121222112121212222221
111112122122222222222221212122122111212222121131111221211211111222222221121221222222111121211211112221122121212121222222222222222122212112221211111121
112212221122222222222221222112221112212112122212221211211221111222222221221212211212122221222222122112221122112121222222222221212111112211212212221221
122122211122222222222221111111112221112112121122122211222122221222222221212212111212221221212211221122111112122122222222222221122212221211212112212211
121221122122222222222221222222122122222122112221111111111112121222222221211112222121111121111222211221222222221222222222222221121222121212212221212111
121222112122222222222221211112121211111221222121222222222212121222222221222221112122222222221211112211112211211111222222222221221111221211111121212221
122211222122222222222221221222121222222222211121222222222211221222222221111122212111111121122112222122221122122211222222222221212222212212222221211121
121122212122222222222221121211122111111121122211222222222212221222222222221311222122222222112112122121122221221221222222222221221111122122111112222121
122112212122222222222221221212212222222212221221222222222212121222222222222222122122222222122222112122212211222121112111111111122222222221222222111221
112222111122222222222221211221222111111222112121222222222212121222222221211212112122222222111111112111221212212122222222111211111111211111222121111211
121211222111111112111111212121111111111211112221222222222222211222222221212212112222222222112222222221121222121221111112222212222222222221212112222211
122211212211222222112221212222212222222222211221222222222211211112111111122112212122222222112222222221221111221211222211122112222222222221122112111111
122111221211211212222122211211222222222222211211222222222211221112222111121111122122222222112222222222211122211222211222212112222222222221222212212221
121221121211212211111112111211212222222222212211222222222212122221221222122222221122222222112222222221212221111121111222122112222222222221211221221121
121121121222122221222222221122212222222222212121222222222212121122211212222111112122222222112222222221222122222222221212121112222222222221212221122221
121121221112121121222222221121112222222222222221222222222212221121212211131222221122222222112222222221111221222222221122122222222222222221221122211121
121121212222121221222222221122212222222222212111222222222212111221122122112211121122222222112222222221121211222222221221111212222222222221121221122221
122221212111222121222222221211212222222222212222222222222212112212221121222122221122222222112222222221221211222222221211221212222222222221221212221111
111111212112212121222222221212212222222222212121111111111112221122111122211221112111211111112222222221212211222222221211211211111111111111212112112221
122222212122112211222222221122111111111211112121222222222222122121222211211212221111222221111112111111222121222222221221222211121111111111221222111221
121111112122221211222222221122211111222222122121111211111121212222211221221212122222211122211112222222211121222222221121221122211222222221222211222211
121222122211121222222222221221122221212212121221222222222222111111111122111212211111122111222222111111212222222222221221211221221222222221211122221111
121212211222211121222222221211221122122122121211222222222112122222222112222211222222212222111111111111211121222222221211221222121222222221221221322221
122211212111212221222222221211212122221121121221222222222112122222222121111211111111211212212222222221212221222222221221122112121222222221121211121121
121122212221212121111111111222212221112222121121222222222112122222222121222222221212211221112222222221212121222222221122112121221222222221122122212221
112222122112212121222221222111111111111112212221222222222122222222222121222222221222122222212222222221222121222222221212112121211222222221212121212121
122112212222222121122122212112222222222211212111222222222121122222222122222222221211121111212222222221111221111121111212212221211222222221212121221121
121111111111111122221111112212222222222212212211222222222121122222222121222222221211221122222222222221222222222222222212221122211222222221212221122221
122221222222222111111222111222222222222212121221222222222222122222222121222222222212222121212222222221111112111111111212122211121222222221221112211221
122121222222222122221212221212222222222212121121111111111112122222222121222222221212212122112222222221122222222222221221211222221222222221122222211121
111221222222222121121211121212222222222212122221222112221122122222222122222222221221221112212222222221122222222222221122222112121222222221121111212221
122221222222222121122211221212222222222212221112212222122121122222222121222222221121112221212222222221122222222222221221111122121222222221121222122111
121121222222222122211122211222222222222211223111111111112122122222222221222222221121122122212222222221122222222222221211222221221222222222221212121121
122121222222222111222121122212222222222212121122222222222112122222222121222222221122121211212222222221122222222222221211211112211112111121211212221221
112111222222222121211221121112222222222212122122222222212222122222222121222222221222122111211112111111122222222222221221212221122122222221211211112221
112221222222222122211212222212222222222212212122222222212211111111111121222222221212212221221222111222122222222222221121222122121121111121211212222121
111121222222222122121222111112111111111112122122222222212122222222222211222222221121212121121212222212122222222222221221111212221121122221222222111121
122221222222222121221211122212131121222222221122222222222122111111111211111111111221211221121111112122222222222222221212221222122221221111111111111221
121121222222222122212211221212222221212111122122222222212112222122211212222212222211211212121222221222222222222222221122122221211112211222222222221211
121221222222222111111112211221121112212122212122222222212211122221211221121221221211222212222211122212112111111111111221111122111122121222222222221221
122111111112111111222112112121122222221221221122222222211222121112212221221121211221112111111111211122122111111111111212222211222221221222222222221121
112222222212212222212222222121111111111212122122222222212112212222121121212121221121222222222221222121121122222222211211221211211111211222222222221121
112111211221222111111111111122222222222212112111111111112111221221122221212121122211222222222221122121121122222222211222211222211222221222222222221121
112111222112221122222222211221222222221222112211122221112222121212222111212121111221222222222221121122122122222222211111211111111211122222222222221221
112222112212112122222222211211222222221112221222221112222112121221222222212222211121222222222221322212112122222222222212222222221212221222222222221211
121112211222112122222222211221222222221221121111211222111212122122111111111111222221222222222221122112122222222222212112222222221212121222222222221221
122221211111222122222222212122222222221212122211211211222212212212122222222221112211222222222222222212121122222222212212222222221212121222222222221121
122121212211112122222222212221222222221221211211221222122111221222122222222221221211222222222221211212121122222222211212222222221212121222222222221221
121221212122222122222222211221222222221122211212122112112122122111122222222221211221222222222221211222122122222222211212222222221212121111111111211211
112212212121212122222222212211222222221222122222122212122221212222122222222221221121222222222221211111112122222222211212222222221212212221222221212211
122122112221212122222222212111222222221212121311221222221122231112122222222221121121222222222222222222222111111111112212222222221221222122211121212121
121121122111212122222222212221222222221221121111111111111111222212122222222221122121222222222221111111112112222111222112222222221121121211122221222121
121122211111211111111122112121222222221222222212222222222212121122222222222221222221112111111111222221112222112222212112222222221221122112221112112221
122111222221222222221222122121222222221211111212222222222212221222122222222221211111122211222122222122221211111111112112222222221211212112122112221121
122222111121221112122212211221222222221222122112222222222212111212122222222221112222211222212121122211121222222222212212222222221222212221212211222221
121222222121222212211122231211111111121112112212222222222212212212112111111121222121221221122122121221121222222222211222222222221111111121211221211111
111211112121211111222211211221222222222212221212222222222211122122112221222221211221122112222112212121122222222222211212222222221222222121222122122221
122211111121212222111211211122211211111111121212222222222212221221312112211122212212222222112221222122121222222222211211111112111211112221212212121121
121122222221122112221211222111111222112222121212222222222212111212222312122211112122111111222111112112111222222222211221122222131211112111112222121221
122121111111121221121212112221222112112112121212222222222212221211212112221212112122212221211222212212221222222222212121221212222212222222212111221211
112122122212221222122212221121212112122112222212222222222211121222212111112212212211112122122211221211121222222222212122112211121112222222212112211221
122212121222112212211122121221212122121221111212222222222212121211122122212121211222222112221221122211221222222222222112212211122112222222212112121121
121112122111222221211121221212212121122222122112222222222212121211121221212211211111112111112221112221211222222222212221221222112112222222212222122221
122212212122213121222222112211112122111112112111111111121112121122212212221211212222222222212112221112211222222222212211122112212212222222211111121111
121211212111111111111112122112222212221112122211222221222222122221222122121222212222222222211222121122221111111111111222212122221212222222212222122121
121221222122222222222112221222122111122222121212211122212111111111111221121112212222222222212211122221122221111111111211212111111212222222212112212121
121122111122222222222122112212111222111111222112112211112222222222122212222121212222222222212111111111111111222222221222122122222212222222212111112121
122112222122222222222121222112222212222222212222222211222122222222121212112221212222222222212222122222222211222222222211121221111112222222212122222221
112111211122222222222122111111111111111111111111111212212122222222121221111112212222222222212212122222222211222222221212221212222112222222212121111111
112221222122222222222112222222222222211222222222222212112222222222122112222222112222222222212112222222222211222222221212111212112112222222222121222211
111122112122222222222112122222222222211222222222211122112122222222112222111111212222222222212212122222222211222222221222122211122112222222212121211221
122212112122222222222122122222222222211222222222212221212122222222111121111111212222222222211112122222222211222222222211212122222212222222212121211121
121122112122222222222121122222222222211222222222212111222122222222112222222221211111111111112222122222222211222222221222122122121211111111112223122221
121221122122222222222121122222222222211222222222212222112122222222112222222221222122122222112111122222222211222222221112121212121211121112221121121221
122211222122222222222122122222222222211222222222212112112111111121112222222221212212221212222221122222222211222222221122121222112222212222121121121121
121122212111111211111112122222222222211222222222212112112222122222212222222221211221112211113121122222222211222222221121122122221111222111221221121121
121221212222212221222222122222222222211222222222212112111112121111222222222221222122221122211121111111121111222222221122212121121222211222112211122211
121211221111222112211111122222222222211222222222212112122122122222112222222221212211122221222222222111122221111112211211222121221211112212112122211221
121212221111111122122211122222222222211222222222222212121221111112212222222222221222211221112211112122221212221222222222111221212212222112212121211121
121221112222122222221222111111111111111111111111111112122212222211212222222221121111211112221122211221111212111211122111111211211112111221212121222221
122122222112221131112112222222222222222222222222222222122222111222211111111111222221222222122221222222221222222222212222222221222222222211222221111221
111111111111111111111111111111111111111111111111111111111111111111111111111111111111111111111111111111111111111111111111111111111111111111111111111111
