111111111111111111111111111111111111111111111111111111111111111111111111111111111111111111111111111111111111111111111111111111111111111111111111111111
122222221222222222122222211112222222212222222211212222221222221122222221222222221222221122222211122212221222211121222222222222122222222112221222122221
121112112211211111121121212222121111212122111212212121112212121221122122212111122122121221111212221222122211222221212111121112121112212122122212221221
122212212121222222221221212121121212211221221212122122112122111212212211122122212221121212222212112111111122121111212122212221122122112121111111121211
121221212122111111111211221221121222222212122212222212222121222222211221111121221112122122111122112111222121122222212221222122212121222211222222211211
122122112212122222112211121111121111111111111221211112211221212111222122222221122212212221122221122222212221111111111212111212112121211222211111221211
112212222222121112212122222222221222222222221121212221212212212111111111111112211221222112221112221111211121222222221222222212222121122111112221121211
111111111111122112222111111111111222222222221121122121212112121122222222222112112121111122111111111111212121222222221111111211111122121122222122122211
112222222222112122111222222212221222222222221122221122112122122122222222222132222121122221212222222211212121222222221222222212222112122121112211111221
112222222222112211111211111222121222222222221211112112132221212122222222222112111122221112212222222212212221222222221211112112112112212122212122211121
112222222222121212222222222111121222222222221222212222112111212122222222222112211111111122212222222212121121222222221212221222112221212221212121222221
112222222222112222111111111111221222222222221211122211122122222122222222222121222222222221212222222212122121222222221122122211221122212211212122111111
112222222222112111122222222211211222222222221212221122222221112122222222222121111111111211212222222212112221222222221221121111111111111112212112211221
112222222222122121122222222212211222222222221222111111111111212122222222222121222222221222112222222212221111222222221212221222222222222212121222222221
112222222222121122122222222212121222222222221221212222222221222122222222222121222222221212212222222211122211222222221221121221111111111212122211311121
112222222222122112122222222212121111111111111212212222222221221122222222222121222222221221212222222211111221222222221121221221222222221212222111122221
112222222222112112122222222212222222222222221212112222222221211111111111111121222222221121211111111112221121222222221121111221222222221211111222121211
112222222222112112122222222212111111111112121212112222222221222211222221122221222222221213222212222222122121222222221122221221222222221211222212211211
112222222222112112122222222212122222112221221212112222222221111222121122212211222222221122211221111221112121111111111111121221222222221212211121211221
111111111111122112122222222212212212122122211212112222222221222112221211221221222222221222122121222212212121112222212221121221222222221212112221221121
122222211211122222122222222211222121221111111212212222222221212211111222121121222222221212212222211121222221222122112121121221222222221212221223122211
121211222122221111122222222211211121212222221221212222222221221221112221122221222222221221111111111111111221211222122122121221222222221211122221211221
112212112121112221122222222212212221212111122122212222222221121122212122111221222222221121122222222222221121221212121212221221222222221211111121221121
112122112111122121122222222212122122212211212112212222222221121211212212222121222222221121122222222222221122112212121222221221222222221212222121121221
122122122122221221111111111111221211122222212211211111111111221211221212111121111111111121122222222222221212212112121111121221111111111212111122221211
121212222221111211122122212222211111111111112221212222221221213222122212222222222222222221122222222222221211212122122221221111111111111112222211212211
121111111111111222121221222121212222222222112122212111122212211212211111111111111111111122122222222222221222222121311121113122122222221212111222212121
122122222222122112222111111221212222222222112211122221112212121211212222222222222112221112122222222222221211311222222122222221121221122122112111112211
112122222222121111112222222212212222222222121222111122211212122221112222222222222122122222122222222222221222111111212211212112221122211121222211221211
122122222222122222221111111111112222222222122211222111211122122122212222222222222121211111122222222222221111222221221111212112112211222221221212211211
121122222222121111221222222222112222222222122111212221212221221111212222222222222122122211111111111111111112211122112222212212221221111111121222212211
121122222222122122221222222222112222222222121221211122212112211222212222222222222112221222112222212222221222112212212122111121121122222222221111212121
122122222222112121121222222222112222222222122122222211212122111211212222222222222121112112222111112111121211112122222112122211122212111111111111112121
112122222222112122111222222222112222222222112211111222112121122211212222222222222112222221121222212222122212212221111221221222111212122222222222212221
112122222222112112221222222222112222222222121212221112222121121122212222222222222122113112221211212212211121222112222212211112122212122222222222212121
122122222222122121121222222222112222222222121222122221211112221121112222222222222121111222111211221211211122211122122112122112221112122222222222211221
121111111111121121221222222222112222222222122111211121222222112222211111111111111121222211111221121221222211111221212112212111111122122222222222211211
122222211111222121211222222222112222222222121111211121111111111111112111222222222121211112222121221121111211222221212211212221222222122222222222211211
121111212222112121221222222222112222222222121222212221222222222222212222212211112121221222112121212223111221211122211222211122211212122222222222211211
122122212112212222121111111111111111111111122211122121222222222222212211121212222222122121222121221121222121221211111111111111221212122222222222211221
112121122211212111121221112212222222222111221221221121222222222222212122211211112111112221211221122121212122122212222222222221111212122222222222212121
122121221212211222222212221212111112212122212121212211222222222222212111221212221222221111221212112111212221211212222222222221122212111111111111111221
111221211212112211112122122222211121221221122121221221222222222222212221121222122211122222121212222222211222211212222222222221221112112222222122211211
122211112212222121222121211311222221122222221222122121222222222222211122221111111111111112221221211111111111112212222222222221212221222111212121212231
121122222221111122211221222221111111111111112212212221222222222222211111221222222222222212212121212222222222122112222222222221212122211112211121222211
122111211121222112111212111211222222222221222121211221222222222222212222121222222222222212112122112222222222121212222222222221222211212222122221111211
112221222121212212122212111211222222222221211122222121222222222222212121221222222222222212112112212222222222121212222222222221213111212111221111221221
112122112212211221121122221221222222222221222211311221222222222222212121211222222222222212212221212222222222121212222222222221221222122122212222121121
112212211212112121122221121121222222222221221222122211222222222222212112211222222222222211211121212222222222121211111111111111112212121121122112221221
111111221212222121111112121221222222222221212112221121111111111111112212121222222222222211222221212222222222121222212222222222222112221122122122212211
122222121221112122222222222211222222222221212211112222221222112222221222121222222222222212211121212222222222121111222121111111111111112222212211212121
121212221122222111111111111111222222222221221222221111122212222111122222221222222222222212122211212222222222122111112121222222222222212111211212212221
121211111111111111222222222211222222222221122112122222121121111111111111121222222222222211121212211111111111112122221221222222222222212211221211111221
121212222222222211222222222211111111111111212112111112121222121222222222121222222222222212221212122222221212222121122211222222222222211212121222222121
121212222222222211222222222212222222222222212222122222122212221222222222121222222222222212111222121121122122111121211211222222222222211222122121221121
121112222222222211222222222212111111122111111111221111111111221222222222121222222222222212221111122122212121222221221221222222222222212112212122122121
122212222222222211222222222212221222121222222221211222222221121222222222121222222222222212122222212211221221211111121121222222222222212221212211212221
121212222222222211222222222211121212122211112121221222222221221222222222121111111111111111111122122222122222212122221221222222222222212121221222132211
111212222222222211222222222212121221211122212122121222222221211222222222121222112222222222221221121111111111112221221211222222222222212211222112112111
122212222222222211222222222212121222222212212111221222222221211222222222112212212111111211121212221122222222212111212211222222222222211222211112122221
121112222222222211222222222212121212121122212211211222222221221222222222112111212222121221122212112122222222212121212121222222222222211111122222111121
122212222222222211111111111112122122122221221222211222222221121111111111112122211112221121111112112122222222212121212221222222222222212222221121122211
111212222222222212122222221122212121111111111111111222222221212221311222222121122221112221222212221122222222212221221221222222222222212111111221221221
112211111111111112121112122221212121222222222222211222222221222122222122111221221122221122211211121122222222211111122121222222222222212211222111212121
112111312222222112222122111112212221222222222222211222222221122111212221222222212212122111122222121122222222212222112121111111111111112222212222222121
122122222121112211111221221222221121222222222222211111111111221221221111111111112112112221112212121122222222212112222121222222221222112111111111111121
121121221112221222222212222213112221222222222222212222222211212212121222222221222221221121222122121122222222212221112121122111122212221221222222222121
122211222222122121111122111221112111222222222222211211111212212212121222222221211122212121211111221122222222212121112122221111111121121121222222222121
121221212111212121222111112221222121222222222222212212222222121222221222222221222211112121222221212122222222211221222111212222222222222221222222222121
121122112221212211212222212121211121222222222222212111111111111111211222222221121122222221211122222122222222211211211111221111111111111111222222222121
122212221121211221221111211221222121222222222222212122222222222212211222222221121221111111111111111122222222212211221222121222222222222211222222222121
111221121222222122222221213222112121222222222222212122222222222212121222222221221212221222222222221111111111112121121212121222222222222211222222222121
122121121111111111111111211211112221222222222222212122222222222212211222222221211221121222222222221222221113122122121122121222222222222211222222222121
121121122212222222222122212212221121222222222222212122222222222211211222222221222122121222222222221211121222221112122121121222222222222211222222222121
121121111212222222222121122112122121111111111111112122222222222212211222222221221222121222222222221222212212112222122223121222222222222211222222222121
121222221212222222222121221222112221222122222221122122222222222212121222222221222112221222222222221221222122122112221121221222222222222211222222222121
122211111212222222222121111211111112212211112121222122222222222212221222222221212221121222222222221211112121111111111121211222222222222211222222222121
122112221212222222222122212212221112121211222121212122222222222212111111111111221122221222222222221122221221222222222121211222222222222211111111111121
122212122212222222222111222222122222121212221222212122222222222212122221111111111111211222222222221221122211222222222121221222222222222212222222221121
121122112212222222222111111111111111122222122111122111111111111111221122122222222211221222222222221211211211222222222121121222222222222212111112122121
121121211212222222222112222222222122211111211222121112222222222222212212122222222212121222222222221222111211222222222112221222222222222211222222112121
112221222212222222222112222222222121221222212212212222111111111111111212122222222212121222222222221212221211222222222122121222222222222212211111112221
122111211112222222222112222222222121122212222122222122122222222222221212122222222212121222222222221212121221222222222121121111111111111112122221222121
121122222112222222222112222222222121112111111111111111122222222222221222122222222212221222222222221122122111222222222122211222222122212222121121211211
122211312111111111111112222222222122212122222222222221122222222222221211122222222212211111111111111121112221222222222111212211212222122111222211211221
121222132222222222222212222222222121212122222222222221122222222222221221122222222212111111111211111121221121222222222121211112221112121211211211221121
122112112111111111111112222222222121212122222222222221122222222222221121122222222212122222222122222122212221222222222122222122121122121221211221222221
112212221122222222222112222222222121212122222222222221122222222222221121111111111112221111112121112211211121222222222111112111221221221121222122211111
121221121122222222222112222222222112212122222222222221122222222222221221221111111111111112212122221222212221222222222112212222212211212221112111122211
121121122122222222222112222222222122122122222222222221122222222222221211211222222222222112112111111111112121222222222112121111112112212122112122221211
122121212122222222222112222222222121121122222222222221111111111111111221211222222222222122112122222222122111111111111122122212222112122111222121111221
122222212122222222222112222222222121121122222222222221122112222222211122231222222222222121222122222222121222112212221121222122111122121111211221222121
121111122122222222222112222222222121122122222222222221221222111211222211211222222222222121211122222222121212222112122222212221222221121222212222211121
122221222122222222222111111111111122212122222222222221211211221222111221211222222222222121212122222222122211212122111111111122112112222212122111122221
111212212122222222222111111111112211221122222222222221222213121221222112211222222222222122212122222222122122212121122222222112112122111112121222221221
122212121111111111111112222222211222122122222222222221221122222122212122121222222222222121122122222222122212212122122222222112212111222221121211112221
121112212222221111222212222222212211112111111111111111211222112211112221121222222222222122222122222222111112112212122222222121212122211122221222122121
122211212121112221212112222222212112222122211222221311221212111111111111221222222222222111112122222222122212122212122222222122212221122211111212211221
111211222122222122212112222222212111111121212211122222121212122222222221211222222222222122212122222222121222121112122222222121111112222111112212221211
121211111111111111112212222222212222212222122122111212121212122222222221221222222222222121122122222222122112111222122222222122222221112122221112122111
122212212222222222121212222222212112122112121121222212121221122222222221121111111111111121121111111111112122122211122222222111111122222121122221112221
121122212222222222122212222222212122121222122221211122122122122222222221122222221222222122122222221222222211221111122222222112222221111121211122221121
121221212222222222112212222222211221221211111121222111112212122222222221212111121212212122211111121211111221211222122222222112111111222221222211121221
122212212222222222112112222222212212212211221221112222211222122222222221212121122122122121222222121212221122212212122222222122122211211212221222222211
111122112222222222122112222222212112122122211212221111212112122222222221222122222221222212212211221112122211122112122222222121121211211211111111111111
112221212222222222121212222222212222121121211221122112222122122222222221211111111111111221221222221222111212221122111111111121221222212211222222222211
112111212222222222122211111111111111121121211122112122122121122222222221212222222222221121122111122211222222112221222221122211212111122221222222222211
122122212222222222122122122222222221122121222212112121111122111111111111212222222222221221212212111111111111111121212122121212212212222121222222222211
121121212222222222122211221221111122212122111222222122222212122222221111212222222222221211221222122222222222221121212212221222121222112211222222222211
122121212222222222121221212122212211212112221111111111111212121221121222212222222222221221122211122222222222221221211221111111111111111211222222222211
112121212222222222112122212211212221212221121222222222212212211211221211112222222222221122111221122222222222221212222121222222222222211221222222222211
122121212222222222122111131211212121222122121222222222212122222212222211112222222222221212212221122222222222221211311121222222222222211121222222222211
121122112222222222121112222212211221222111121222222222212111111111111122212222222222221211221122122222222222221222122221222222222222212221222222222211
121212111111111111122222121212122221211222221222222222212122222222221111212222222222221221121212122222222222221212221111222222222222212121222222222211
122112222122221122221111221122121121212211111222222222212122222222221222212222222222221121121212122222222222221211112221222222222222211221222222222211
112111211221212221212212212221322112212122111222222222212122222222221211212222222222221221121222122222222222221122222121222222222222211211111111111111
122122211211222111222122122211122222122122221222222222212122222222221212212222222222221212121211122222222222221221111221222222222222211212222122222211
121221111221111111111121121212221121221121121222222222212122222222221211111111111111111222121221111111111111111211222211222222222222212212212121121221
121122221121222222221122122122111121212221121222222222212122222222221222222221222221112221121122122222221222212222121121222222222222212221211221121121
122211121121222222221212212121222211211111221222222222212122222222221211112112211122222122121212121212121211221112122121222222222222212112222211221221
111221122121222222221222212121211221222111211222222222212122222222221222112222122111111112221212111212112211122222112221222222222222212212121112211211
121122212121222222221212112212212122112122211111111111112111111111111112221111212222222221111222222211222122211111211221111111111111111221122122111211
122221122121222222221212221222222112222221111222222212222122221222222111121222211121122121222111111122211221221111122121222211112221222122212121221211
121111121121222222221212211111111111111121222122111222112212122211212222121122122211221221211222112221122212222222221122211222221222212211211221222211
122222122221222222221221212222222222221221212212111111221212211111211112122212221212212212222212122112221221111111111111122111121211121221211212211111
111112121111222222221121212222222222221212211212122222121221112222211112111222111222122221221112221122112122212222222222121221221212223121221212122221
122212121221222222221212212222222222221112112212121212221122222111122212211111111111111122212221111122212211212222222222122121211212121322122212221121
121212121121222222221222112222222222221222112122211212111111111221121221212222222222221111122121222211211221212222222222112122211221122121111121112221
121222122121222222221212112222222222221211112211211212122222221121222121212222222222221222221121211221221221212222222222122121111222212121222221112121
122111212121222222221212112222222222221212221211212212121112212221212211212222222222221212112222212121122221212222222222121121222211222122211212221221
112122212221111111111212212222222222221212121212212111221221222122221222212222222222221112122111112222211121212222222222122221111111111111211212122211
122121222222122221112211212222222222221212122222122222212121111111111111212222222222221222121122211211222211212222222222122112122222222221211212111121
121221111112212212221221212222222222221211111111111111212221222222222221212222222222221211212221222122111222212222222222121222122222222221221222122211
122122122211222212121112212222222222221221222222222221211221222222222221212222222222221222122111112112221111212222222222121212122222222221121111311221
112111221222111212122122212222222222221121222222222221222211222222222221212222222222221212121222112211122111211111111111121122122222222221221222222121
112212211112222122112221212222222222221121222222222221111211222222222221211111111111111212222212221222212222221222211222121121122222222221211211212221
122212112221112121111112212222222222221121222222222221221211222222222221122222211222212111111111121111212211122211222211221122122222222221222112221121
121212222122122122222211111111111111111121222222222221212211222222222221221211222121222122222222122221212111111122112122212212122222222221112112122121
112212111212212212212222222122212222222121222222222221222221222222222221211211112221111122222222111121221122212221122121122222122222222221122112112121
112112122211211221122111212221212112211121222222222221221111222222222221222122211112222122222222111122122221221121221122121112122222222221121122112211
112212221112211122121222211111211222122221222222222221212221222222222221112121211112112122222222122212111112122122212112122112122222222221121121111221
111221221112122212111211122211211212121111222222222221122121222222222221112121222212112122222222121212112221112122221222111222122222222221122212222121
122122112222121112221211221221211212122211222222222221121221222222222221222122111212112122222222122112112122212121111211222212122222222221211212112121
121222212111122221122212212121221212111211222222222221221211222222222221211222111222212122222222112222112111212212221222122112111111111111121222122121
122111212212112122211122112121122212211221222222222221212211222222222221222112222113112122222222112111212211221212122112212212212212221222221111221221
112122211212222122112221222122111121212121111111111111212111111111111111212221112211222111111111112221222221121212112221221211222212122211212122212221
132221122212211112221121112212222221212121122222222212212122222122222221211122221221211222122211111121111312221212212112121222111212211121212121122121
112111221122122211121222212111111211222121121122111122112221221121112211221211122121222212221212221221222122121221212221221221111112222221222222221121
122222212222221222122211222222221222222122222212222222221112122222221222222222212222111121111222122222212221122122211122222122222222111112113131112221
111111111111111111111111111111111111111111111111111111111111111111111111111111111111111111111111111111111111111111111111111111111111111111111111111111
