111111111111111111111111111111111111111111111111111111111111111111111111111111111111111111111111111111111111111111111111111111111111111111111111111111
121122222211212222221222222221222222122222212222212222222112222222221112221112222122222111122222222112222222222222222222222222222222221222222221222211
122121111222122112121221111122121221221211122121221121112212111111122212122222121221211222211211212221111111111111112121111111111111121212211112211211
122221222112221222122121222112121212211222121221212221221212222222211212211121221211212211211221221121222222222222212111222222222222112212222222121211
121112212221112211112221212122121212122112221212212111121221111121212211222121212212212121222121121121222222222222212221222222222222122112111111121211
122212121121222122211112211221221222221222211211122112221212222121112121211121212112112121112221221221222222222222212121222222222222121221311112221211
111222121221211121222222112222111111111112121222121122121222112221222122212221212112112121221211211211222222222222212121222222222222121222222212121211
111111212212212221112122122112122222222212121112122221111111111111211122112112212112222222211221211221222222222222212121222222222222121212211221221221
122221222122111112222111221221122222222212222122212211222222222212211221112221122121111111111111222111222222222222211121222222222222122112122121212121
121112211221122211121122212222122222222211212121211211222222222212122211221121221322212222222221212221222222222222212221222222222222112122121221212121
122222221212221222221121122112122222222211211221122211222222222212121122222122211122112222222221221121222222222222212111222222222222122121221211222121
121111112212211111111122111122122222222212211212221121222222222212122121112111122212212222222221121121111111111111112211111111111111121121212211112121
121222212121222222222222222222122222222212121222111121222222222212222221222222221221212222222221122122221122222122211212222222222122221121222122222121
121111212211111111111111111112122222222212223111122221222222222211111111111111112121212222222221222212122212112221222222111211112221112223112221221221
122213221222212222222222221212122222222211121222221221222222222211222222222222212122212222222221213122111212211111111111111212221113111121122111111211
111221222111212222222222221212122222222211221212111121222222222211222222222222212212212222222221211221122211212212222222221221222122222221121122221211
122121212221212222222222221222122222222212212212122211222222222211222222222222211211212222222221212212211221221212222222221121212112111112122121121211
121121212121212222222222221212122222222212122122121221222222222211222222222222212211212222222221122111222121122212222222221221212212212222212121221211
122221122121212222222222221122111111111112221221121121222222222211222222222222212122212222222221121222212122211112222222221211221221212111212121222231
121112221221212222222222221121222111111111112211221221222222222211222222222222212221111111111111121211212111222212222222221222121121221122212122121211
122222111212212222222222221122112122222222122111211211222222222211222222222222212111222221222222222122212222111212222222221211221122121121122112121211
111111222112112222222222221212212122222222121222211221111111111111222222222222212112211121211111212121221212122212222222221222211112121122121112212211
112222212222111111111111111211212122222222112211122122122222122221222222222222212112122221122221212121121221221112222222221111122222222212222211221221
122112111111111112112222222211212122222222112122221212112212121121111111111111112212121211221121212121221111212212222222221211221111111111111222121121
121212122222222212222121112211212122222222122121221222122112122212222222222222221212212211212221212121212221211212222222221222212122222222221112121221
121222122222222212211222221222212122222222121122121221221212111222112111111111121221212122212111122121222122222212222222221221112122222222221222121211
121112122222222212111111111121122122222222122112122211121222222111112122222222122111212212122122221111111111111211111111111211222122222222221211221221
122221122222222212122222222121112122222222112122111122221113112222222122222222112222211222122211221222222222221212221211121222112122222222221221212121
121121122222222212122222222121222111111111112121222221111111111111111122222222111111111111111211211222222222221222122122221112222122222222221121221221
112223122222222212122222222121212212221112222122111121122222222222221122222222122122222222212212211222222222221111112121212211221122222222221122121211
122121122222222212122222222121221222122222121212222221122222222222221122222222121122222222212112121222222222221122222121221222121122222222221212121211
121121122222222212122222222122122111112211122121111223122222222222221122222222122122222222212112211222222222221121111221122221121122222222221122121221
121121122222222212122222222112212122212122212122222221122222222222221122222222112122222222212221211222222222221121222212211121121122222222221121122121
121122111111111112122222222111212121211121222111111122122222222222221122222222112122222222211121221222222222221121211111211122122122222222221221212211
122211111111112212122222222122221121222122122122222212122222222222221122222222112122222222212121121222222222221121212222222112112122222222221211211221
121212222222212122122222222121122122112112211121111221122222222222221122222222112122222222212122221222222222221121222111312112112122222222221221211121
122112222222212221122222222112212122212221222122112122122222222222221122222222122122222222212111111222222222221121111222222112112122222222221121212221
112112222222212112122222222122122121211122112222222112122222222222221122222222121122222222212222121222222222221122221111211112222111111111111222212121
122112222222212212122222222121221221212112111111111122122222222222221122222222122122222222211212121222222222221211122221212221111221112211111111112211
121212222222211222111111111122211112212222122222222121122222222222221111111111112122222222212212121111111111111222211121212122211122221212222222212221
122112222222211212222222222121122222112211122222222122122222222222221221111122212122222222212112222222122221122221221122122111222122121212222222212121
112112222222211211111111111222221111222122122222222112111111111111111212222221212111111111112221111211121122221121121212221112212221122212222222211221
112112222222211212222222221111111111112112122222222132222222122222222212111112212122211122221122222122221311112121122211112222221112211212222222212211
112212222222212212222222221122222222212222122222222112111211121111111212112212122221122221121112212121112222212121111111111111111111211212222222212111
121212222222212112222222221122222222211122122222222112111222221222111212221222122111221211222212112122121211222121122222222222212222212212222222212221
112212222222212112222222221122222222211212122222222112222111111212122211121221112211211221211211112112212211122121122222222222212111212112222222211121
112112222222212112222222221122222222212212122222222121112111122212221111221212221222222121112222222221222122222121122222222222212222122112222222211121
112112222222212212222222221122222222212122111111111121111222121121112222211222121221111322212111111111111112211121122222222222211212121212222222212221
112211111111111212222222221122222222212121222222222222222212221222112111112111122121222121211212222222212212112223122222222222211211121212222222212121
111212111122222212222222221122222222212221211111111111111131112212122122222212212121212121222112222222211222112121122222222222213222221212222222212121
122212222221111112222222221122222222212112212222222222221222222122121121121222112121212211112112222222211211112121122222222222211211112212222222212121
121111111111111112222222221122222222212211212222222222221222111221121122122111122121211222122112222222212211222122122222222222212212221212222222212211
121222222222222112222222221111111111111212212222222222221212112222221222212111121221212112121112222222212121211112122222222222212112122211111111111211
121222222222222112222222221222222222221212112222222222221212212111111111112122221212212212122212222222212221212222122222222222212221122212222222211211
121222222222222112222222221211211111212212112222222222221221221122222222212121111122112222121212222222211121221121122222222222211122121212112211221221
121222222222222111111111111122212211212112212222222222221121121122222222212222222221222121221212222222212223122121122222222222211112122112122112223121
121222222222222122111311122221122122212211212222222222221221221122222222211111111111111122112212222222212121212122111111111111112222112212121221121121
121222222222222122222222212212121221111222212222222222221212222122222222211222222222222112212112222222211221212112221112212221112111311212121222222121
121222222222222121112211222112222222222111112222222222221212112122222222211222222222222121222111111111111212212221122221212122222122222212121211112121
121222222222222122212111111111111111211222112222222222221212122122222222211222222222222112121222222222111222122121111121222111111121211122121122212121
121222222222222121212122222222222221212212112222222222221212121122222222211222222222222122121211111112222211221112222211211222222221211121122221212221
121111111111111121212122222222222221222112212222222222221122122122222222211222222222222121221212222221111121211222111211221111111111222121211111221121
121222212221122212212122222222222221111121212222222222221121222122222222211222222222222121211211122121122221212211221221121222222221212222222222122211
122211222122221221122122222222222221122212211111111111111122112111111111111222222222222121221222212122221221222122211121221222222221221111111111111211
111111111111111112222122222222222221221212122222222211222222221222112222221222222222222122121111222111111111111111222122211222222221121122222222221221
112222222222212222112122222222222221212122111111221221211111122212222111211222222222222112121221122122222222222221212211111222222221221122222222221121
112222222222212111112122222222222221221221222221212121221121111111111122231222222222222132221122112122222222222221211112221222222221212122222222221121
112222222222212112222122222222222221122222211122212121122221222222221121211222222222222112111112122122222222222221222222121222222221221122222222221221
112222222222212122111111111111111111111111111111122122212211222222221121211111111111111122122212121122222222222221212211221222222221121122222222221211
112222222222212121222221222222212222122222222222122211221211222222221221122222211122222222221222121122222222222221212122211222222221122122222222221221
112222222222212121211122211111212122122222222222121222221221222222221211221121222211111111112111221122222222222221212211221222222221112122222222221121
112222222222212112211211111221222121122222222222122111112121222222221221212121111212222222212122212122222222222221211221121222222221222122222222221121
112222222222212212112221222222111122122222222222112122221221222222221122212122221212222222212221112122222222222221211121121222222221212122222222221121
112222222222211222122121211112211212122222222222121221121211222222221211122111121212222222212211222122222222222221122221121222222221212122222222221221
112222222222211211121221212221212212122222222222122211221221222222221212221221221212222222212112212111111111111111121111221222222221221111111111111211
112222222222211222221211212121212122122222222222122122211121222222221222111211212212222222212122122222122222221122221121211111111111121222222211121221
112222222222212112111211212112212121122222222222121121112221222222221211222221211112222222212121121112121221121121111221212222221222122112111222221121
112222222222212112122212212222222122122222222222121121222111111111111222211121222112222222212211121212211121121121222211212221112212212112111111111121
111111111111112221221122111111111112122222222222121122211222222222222121111121112112222222211222121222222121121121121122212122222221212222122222222121
121111311222111121212121122222222212122222222222122111111111121221112121222221212112222222212112121221312221222221121221121111111111211112122222222121
122222222212221221212223122222222212111111111111112122222222112211212112211121212211111111112212121111111111111112222212211222222221222112122222222121
111112211121122211211121122222222212222122222222122122222222112112212222111122211222212221131212122122222222222212122111221222222221212112122222222121
122222122212222212212223122222222212212211212111121122222222122112131111222112212111222122222212112122222222222212121222121222222221212122122222222121
121111221211113122112121122222222212221122212122221122222222121212222211212221212111111211121212122122222222222211221212221222222221212121122222222121
122221211222221121222122122222222212122221112121112122222222121222121211221221212222222222121212121122222222222211212212121222222221211221122222222121
111121221111122122121212122222222212111111122121222122222222122111121211121212212211111211121122121122222222222211222112121222222221212212122222222121
112221121222212212121222122222222211222122221221212122222222122222211212221222122222221222122221221122222222222211111221221222222221222222111111111121
112122121211221222221221122222222212212121111211112122222222121211212212111111111111112212211112212122222222222212221121211222222221211111122222211121
122112122211111111111112122222222212122122222222222122222222112212212112122222222222212121222222112122222222222212122122211222222221122211221221222221
121122111212222222222212122222222212211111111111111111111111112122112122122222222222212212112211222122222222222212111121111222222221121222112211111121
121221122212222222222212122222222211221222222222221222222222212121212221122222222222211222112122212111111111111112112221221222222221221112112122221121
121212121112222222222212122222222211121222222222221211112111221121212111122222222222212211222112212222111112222112122112121222222221212222122121121121
121212122112222222222212111111111112221222222222221212212122122221222222122222222222212221211122111111222221221222221212121222222221221121221221121121
121212212212222222222212212221122222121222222222221222122121111111111112122222222222211112212221122212211122212213111222221111111111222122121112221221
121212121212222222222211222122221211221222222222221111221221122222222212122222222222212222112121121212111211222121222122121222211222212112122212121211
121222221212222222222211111111111221111222222222221122221212122222222212122222222222212111212122221222222222111122212221221211212211112112211221121221
121111211212222222222211222222221222221222222222221221121222122222222212122222222222212112212111111113111111111111112211212212211111122121221121221121
122212212212222222222211222222221211121222222222221211112221122222222212111111111111112122122121222111122222222222212112222122122222221122222221211221
111212122112222222222211222222221222121222222222221222212122122222222212222111122221222121121122212222122222222222212212111121121111111111111111212211
122231221212222222222211222222221112121222222222221211212112122222222211112222221122112122221112112112122222222222212221122222221222222222222213222111
121211211212222222222211222222221212121222222222221211221222122222222211111111111112112112212221122112122222222222212122121111121222222222222211211221
122122211212222222222211222222221222121111111111111222121211122222222211222222222212112112122121121122122222222222212212212222121222222222222212212121
112121122211111111111111222222221221322222111222212212121222111111111111222222222212212112221121121222122222222222211131212112121222222222222212112221
122121221221122222221121222222221211122112221211212221121112112222212221222222222211212211112221221212122222222222211222212122121222222222222212121211
121121212122121211122221111111111122212121121221212112221222221111222121222222222212211211222112211221122222222222212221112121221222222222222212122231
121122212112121211111111111222222221222122222122122122112213122211111221222222222212121211211212122122122222222222212121222122111222222222222212112211
122211112222121212222222221211111111111111112112221221122121111222221211222222222212122212212122121212122222222222212111211212221222222222222212122221
121222222211212212222222221222122222222222212221121212222122221111121211222222222212211212112221221122111111111111112222222212121222222222222212121121
122111113111112112222222221212122222222222211122121211212111122111121221222222222211211212122112212221222111222221111111111112121111111111111112121221
112212211222222312222222221212122222222222212112111211221222112222122121111111111111211212122222122122122222212122122222222211221222211122222122122121
121221212211212112222222221122122222222222212222222222122212212112212122222211122221222212211111221112121111122112122222222212212222122221111222212121
122122221122212212222222221222122222222222211111111111111111212221222121211222221121111111212221212212112221221212122222222212122112121221112211122121
112111121221121212222222221212122222222222211222222222222211211121111221211211211122122221222122211212212122211212122222222212211112221122222222221121
112222121211122212222222221212122222222222211222222222222212212122111111211221122212121121111211112211212211121222122222222211222211111111111111111221
122112122212222111111111111212122222222222211222222222222212112222222222222112221211221122111211222122211212222221122222222211211212222222222122221211
121122211122111112222211212221122222222222211222222222222212111111111111111122111222212212222211212121122212111311122222222211221212222222222121112211
122121211221222221221222122121122222222222211222222222222212222122222222221121222111131211211121212121221122122222122222222211111212222222222122122121
112112211212211122212112121221111111111111111222222222222212112122222222221121211111222211221121212121221121211212122222222212222212222222222112121221
112112221222121111122122121212211222222122221222222222222211222122222222221221222222221122122222212121121121222212122222222212121112222222222112122221
112221122111322222221221121221222212211121121222222222222212212122222222221211112112121111111111112121121121111112122222222212122112222222222112111121
121121111111121121223222122122221121222222121222222222222212122122222222221222212212121222222222212221121122222112122222222212212112222222222112211221
112221222222222122121211222211211111111111221222222222222212111122222222221111211212211222222222212112222211112222111111111111212112222222222122221211
122112211111111112121221211111212222222221211222222222222212221122222222221221221112221222222222212221211111111111111122222211212111111111111121121211
121222112222222212121122122222112222222221211111111111111112122122222222221212122212121222222222211121212222222222222121221122212122212221222211122211
121211112222222212122212221112212222222221222212222122222212212111111111111222111221121222222222212122212222222222222121211221112221222122211222211221
122212212222222212111221111121212222222221221222121221111211122122222212222121122121121222222222212111212222222222222111211212221111111111111111221121
121121212222222212222122222221212222222221121111221212221222121221122112112222121122121222222222212122212222222222222122212212122122222222222221121221
122212212222222211112121112211212222222221221122211221122112121211112222221112222212221222222222212221112222222222222121122112112122222222222221221111
121222212222222212222112221122212222222221211221211121112112122222221113122221122221121222222222212212212222222222222122221122112122222222222221212221
121111212222222212122112122121112222222221222111222122212122111111111111111112221111221222222222212111212222222222222122111221122122222222222221212121
112221212222222212111222212222211111111111212222112111222121222122222222222212121122211222222222212221212222222222222121222211121122222222222221212121
112121212222222212222211111111111122112212211221121222122122212122222222222212122221121111111111111122212222222222222121212122221122222222222221222121
122121212222222211111112222222222122221222221122211212112111122122222222222211111111111112221122222111211111111111111122122121223122222222222221212121
111121212222222212222212222222222121121221112211222212222222121122222222222211222222222212121121112221212221211122122212111221121122222222222221122121
122221212222222212112212222222222122122222222211111111111111221122222222222211222222222212122221222111212122122211221222222212223122222222222221121121
121221211111111111222212222222222111111111111212222222222211212122222222222211222222222212211112211222212211121221211111111111121122222222222221221121
122112212222111222211212222222222112222222212212222222222211221122222222222211222222222211222211122211121222222122212222222222121122222222222221112221
112112122112222112212212222222222112222222212112222222222211121122222222222211222222222211111212221111111111111112112222222222121122222222222221222121
112212221221112212122112222222222112222222212212222222222212221122222222222211222222222212222212111122212222222212112222222222122122222222222221211221
121221112122211212111112222222222112222222211212222222222212111122222222222211222222222212122122122221212222222212112222222222112111111111111111221211
122222112221221212222211111111111112222222212212222222222212222111111111111111222222222212111221121221212222222212112222222222122112222222212222121221
111212121221121221121222212222222212222222212112222222222212112212222212212221111111111112212212221121212222222212112222222222121222121111122112221121
122212211212122122121211211111211212222222212112222222222212221221221222122122212222222221212122122122112222222212212222222222122121112221221221112221
121122212212112212121212222222122212222222212212222222222212112122122111121221112112111121212211212112112222222211212222222222112221222122212122221121
121121212112122212121221311112111212222222211212222222222212222112212222221211222112212122211222122112112222222211212222222222111121211111112222121221
122212222112221122122121221112222211111111112211111111111111122221212211111221211221212222221112211222112222222211212222222222122221212222122211121211
121212111221111221222121222221122122222112222111222122222222112112212111221122222121211111122221222112212222222212211111111111121112212211221111121221
121211222122221211111221211121112211212221111222212211211212221222212222122211111221221122211111112111211111111111112222212222112222122221211222122121
121222212222122222222212222122222222211122222211122222212211122211221112221222222212122221222222222222222222222222222111222112222111221122222212212221
111111111111111111111111111111111111111111111111111111111111111111111111111111111111111111111111111111111111111111111111111111111111111111111111111111
