111111111111111111111111111111
112122222212222222122222222244
122121121212111221221141111211
121421421122111212221122222231
121121121121221222124221111241
122221224124122111242211222221
121112242222212111212412211121
141222122111222122212212411221
122221222222112221224211222141
121421241241111111121221212221
122212212222222221122422221121
122122112222222221111411211424
142121212222222221422222222441
112122212222222224152222222121
132241212222222221122222222221
112112212222222221422222222121
112122112222222221125222222121
122121212222225221122222222121
121421222222222221122222222121
122221242222222221122222222121
121114212222222221111111121121
121414241111111111222212222421
122222222212411112241224212121
111111114221222222122122212221
122222222122211141222211124121
124112142141122224211222224121
122112221222221111224142211224
112414121241212221121111221211
122222122211222122222222122221
111111111111111111111111111111
