111111111111111111111111111111111111111111111111111111111111111111111111111111111111111111111111111111111111111111111111111111111111111111111111111111
122221222222211222221111113122212222221122222212222211222112222222222221222222222212222222222222221222221222222222222221211122221222211111111112221121
112121111111222211212222222221211221121221221221211211212212112111111121212211111211111111111112121121122221111212111122122221112212112222222212122221
112122222221221211222122112112212211122112211122211211211212122112222121122122221212222222212222122121111121222221222111121221122112212222222212111221
112111111122112221111121122112122122112112122211112211211222121222111121221221211212222222212111212122221212211121212222221122222221212222222212222121
122122211212221121222212221112221112122122121221122221212111221212222222212212211212222222212211222121121222122211211111111111111111212222222211112121
121121222121122211211212111221111222121221221122221111212112221111111111111112122212222222212222112111121111221212212212222222222212212222222211222121
121221112122121122212212112222222212122121211122112221212112122122222222222212211212222222212112212222221222211222112112222222222212112222222212211111
122222212122222121112122112112111112212122122211222122212212212122222222222211211212222222212211211111111211121111222312222222222212212222222212122221
121111212121112221222221222111222211212112121221211111111221212122222222222212211212222222211221222222222222112221212112222222222211212222222212221121
112221212111111111111111211222211222122122121122222221221121221122222222222212112212222222211111111111111112222121212212222222222212212222222212121121
112121212122222222222211212211111112221221121111111121122221121122222222222212122111111111111222222222122211111222211212222222222212112222222212122121
112122122122222222222211222122222221112122222212221122122111221122222222222212121122222222221222222222121212221111111212222222222212111111111112211121
112112222122222222222212211221211111111111111212121112221222222122222222222212122121111121121222222222121222122221122212222222222212111111111111122221
122121112122222222222212122212212222222222221212122221111211112122222222222212112121222122121222222222121111211121221112222222222212122222222221121221
121122122122222222222212212112112222222222221212211122222212222122222222222212212212212112211222222222121222221221212212222222222212122222222221221121
122112221122222222222211212212212222222222221221221111111111111122222222222211222222122221211222222222122111122221221212222222222212122222222221211221
122211112122222222222211221221212222222222221121121222222222221122222222222211111111111121221222222222112122211122122212222222222212122222222221222121
121222221122222222222212121122112222222222221121121222222222221111111111111111222222222121121222222222112121222212211211111111111112122222222221212121
122111122122222222222212122212212222222222221221121222222222221222212222221211222222222121121222222222122121111221221111222222221112122222222221212121
121222112122222222222212211211212222222222221211121222222222221211212122121221222222222121221111111111121221222121122222111111212222122222222221122121
121212122122222222222212111222212222222222221122221222222222221211221121221121222222222122221222212222221212212121111112211222222122122222222221121221
121212121111111111111112222122112222222222221121221222222222221212221221212221222222222111121212222111122222122122222221211211311222122222222221221211
121212221222222222111222111112112222222222221322111222222222221211122211212121222222222121122112111222111111111111111121221222122112122222222221211221
121211112112121112122221222212212222222222221122221222222222221222211112222121222222222122212212212212211222222222222122121212212112111111111111221111
121222112212122112222121211221212222222222221221121222222222221211212221111111222222222121211211212111211222222222222112122111212112122222222212122221
122112111222112121112112222121211111111111111212221222222222221211222122212221111111111121222212212221221222222222222122112222212112211122111212222121
112212221111222122222212111221221222222222122221121222222222221221111112222122221222222121111112111122121222222222222121222211112222222221211221112121
121221121111211211113122112222122112211112211121221222222222221212222212121211221212212121221222122211121222222222222122111211111111111111221122212121
121212221222231222221121212112212212112221222112211111111111111212111221122112212211221221212211221212221222222222222112221212222222222221222211212121
122212112211212221122222212211221222122122112122122221222222122212212122212122122122121211222222212222121222222222222111122112222222222221211222212121
122112112211122121111111111211111111111112112221221122111212111221212221212121221112122211111111111111121222222222222122212212222222222221221111121121
121112221222221121222222221221222222222212221112212212112212221121221111221121212222311112222222222222121222222222222121221212222222222221121222212221
122221121122112211222222221121222222222212122122212112122111122121122112221121212112112212222222222222121222222222222122122212222222222221122211222121
112121221121221211222222221121222222222212111221212212121222212122212221122221222122122212222222222222121222222222222122211112222222222221111111111111
112212212222121211222222221221222222222212222212211222221211212211211122111121111121221212222222222222121111111111111121222212222222222221122222222211
122122122112222211222222221211222222222212211112111111111111221211222212222121221121212212222222222222121111222211222122111212222222222221122222222211
121121111211111221222222221211222222222212121222122222222221121212211121112121212221221112222222222222112222121222211112221212222222222221122222222211
121221222122221121222222221221222222222212221211122222222221221212122211112122212111222112222222222222112112121111122222121212222222222221122222222211
121212212121122121222222221121222222222211111221122222222221211211221212222112212212212112222222222222112122122222221111112212222222222221122222222211
121222112122111221222222221121222222222211222122122222222221211221212222111222221212122112222222222222112212111111212211222111111111111111122222222211
121111222312112211222222221221222222222212212112122222222221222121212111111111121212121212222222222222121212222211222122212122222222212221122222222211
112222112112112221222222221211111111111112112212122222222221212121212122222222121212122212222222222222122231111222111221112112111111212122122222222211
112112112212222121111111111222221312221122121222122222222221212121221122222222121221121212222222222222111212221112222212222222122221211212122222222211
112112121212211212222212221122122222121222122112122222222221211221121122222222121122121211111111111111111222122211111111111111111121222122122222222211
112212121212122212121222122211111221122212212222111111111111222222121122222222122212221222222211222222222122212222212222222222222122112221122222222211
121212222212221112121111111221222122211111111111111222221222221312221122222222121111111111111222112211112121112111212222222222222122221121122222222211
112212111111111122112222221122212211211222222222212211211211111111112122222222121222222222212112221221222112221122212222222222222121121122111111111111
112112122222222121222111122111121211211222222222212112211212222222212122222222121222222222212221122121211222121121112222222222222112222212111122222111
112122122222222122211122212222112222211222222222212112112212222222212122222222121222222222212122112221221211121221212222222222222122111212222212122221
112121122222222122222221221112221311121222222222212212212112222222212122222222121222222222212212211112222212222212212222222222222121222122211212121121
122121122222222111111111111111122112221222222222211211222112222222212122222222121222222222211211222211111111111112112222222222222122212211212212211221
121122122222222112222222222222112112121222222222211211111212222222212122222222121222222222211212122112222222222212112222222222222121131222122122211211
122112122222222112222222222222112122121222222222211222212212222222212122222222121222222222212212121112222222222212212222222222222121222112121111122211
122212122222222112222222222222112121121222222222212111212112222222212111111111121222222222212112122212222222222211212222222222222122221222121222221221
121221122222222112222222222222112122211111111111112222212212222222212112221222121222222222212212111212222222222212212222222222222111121211121211111121
122121111111111112222222222222112121222112222212221121121212222222212222112212221222222222211222111212222222222212111111111111111112221222221212212221
112122212222122212222222222222132211112112122112122222112212222222212111122111121222222222211111222212222222222212211112221222112222112111112221222111
121111211212122112222222222222112222112222112222111112222212222222212212221222121222222222212222211212222222222211222222122212212111112222111122112211
112222211212212212222222222222112112221222221111111111111212222222212222111212111222222222212111112212222222222211211111111111112122211121222212111221
122111112221221211111111111111122111122111122221222222221212222222212111122212221111111111112222221212222222222211221222222222212221221222211212221121
121222212122122212212222222221221222112122211111222222221211111111112112221111121222221222212211121211111111111111121222222222211112222211122211222211
121211112212212221222111222112211211222121222221222222221222212222122112112222121212112211222111122122221222122212221222222222212111111111111221211221
121222211221221121222212212112122211212121111121222222221121122112211212122112122212222111111122212221122212221212121222222222212122222222212121222121
121212221121122112211122121222121111212121221221222222221122121221221122122111111111112222122221112111111111112212121222222222212122222222212122112121
122112121121212222222121122211222221212121121211222222221211121212121121112112222222211112111221222122222222212122121222222222212122222222212112112121
112122122222211113112122222111211121221222221211222222221222222222121221222112222222212212221121211122222222212211121222222222212122222222212212221121
122121111111111111111111121222122221122211111211222222221221131122122222211212222222212221122221221122222222211222121222222222212122222222211211122221
121222222212222222222222122212221122211122222211222222221211111111111111111112222222212121111122121122222222212112221222222222212122222222211212211221
121211111112222222222222112111111111111121111111222222221222212222222222222112222222212122222212121122222222212111121222222222212122222222212222212121
121122222212222222222222122122222222222121222221111111111111212222222222222112222222211111222122122122222222211222221222222222212122222222212111221221
122121111212222222222222121122222222222121211122212222122122212222222222222112222222212221212121212122222222211211111222222222212122222222212221212211
122221122212222222222222121122222222222122211221212212221121112222222222222112222222212122211122212122222222211212221222222222212122222222212121212121
121112121212222222222222121122222222222121122211221212111121212222222222222112222222212211122221122122222222212212121111111111112111111111112121212121
122212121212222222222222122122222222222122121122122211222221212222222222222111111111112221121111222122222222212121222122221222212222122222122122112121
111222121212222222222222112122222222222112122212211221211112212222222222222122222112222121222112212122222222212211212221122112222212221122121212212121
122211221212222222222222122122222222222122122111221121222112112222222222222121212212111122211222122122222222211211211212212112113111111121322211222121
111112212212222222222222121122222222222121212222122221112112212222222222222121221122122211122211221122222222213222211211222221222222212221121122111221
122222112112222222222222122122222222222122121112211111212121212222222222222122122121121222221122211111111111111211122211111122212111222111221221222211
121111222111111111111111112111111111111112122221222222212221212222222222222112212221221111111221122222221222212212221122212211211222111222212211211221
122111111111111211111111111112212221312122111121111211221222212222222222222122221111212221222111221111221212221122112221221211221212212211121222222121
122212222222221212222222221222122122222121211221221212222111212222222222222121111222212122212122222112212212122122212112121222121211222111111111111121
121212222222221212222222221211221111221122122221121221111222211111111111111121222212212211112121311222112121112121122122122122121212111122222222222121
111212222222221212222222221222222222122222222122222122222211111111112221222221211121211211112221122211112122212122121121212121221212221122222222222121
122212222222221212222222221211111111111111112111111111111212222222212122211111222122221212221112121111222111212111221122212122212212122122222222222121
121112222222221212222222221211122222222222112122222222221212222222212111122212112211111222122222122222211222212222222221112111212112212122222222222121
122212222222221212222222221222122222222222112122222222221212222222212122221222111222222121111111111111122211211111111111112222112221212122222222222121
111212222222221212222222221112122222222222122122222222221212222222212221221111222122121121222222222221221122212222222222212112111121122122222222222121
112212222222221212222222221212122222222222121122222222221212222222211121112222212211221221222222222221212121112222222222212212222221222122222222222121
122212222222221211111111111222122222222222122122222222221212222222212221122111121221211211222222222221212221212222222222211111111111212122222222222121
121211111111111122111122111112122222222222112122222222221212222222212112221222121121211211222222222221221121212222222222211222222221211122222222222121
121211222221111221222212222122122222222222122122222222221212222222212212111211222121211221222222222221121122212222222222211222222221222122222222222121
121212211121222212211221112221122222222222121122222222221212222222211212112222212121222121222222222221121211212222222222211222222221112122222222222121
121122122122211222222122212212122222222222121122222222221211111111112122112111112121211221222222222221221222212222222222211222222221222122222222222121
122221222111111111111111212222111111111111121122222222221221222222221121212112212222211211222222222221211221112222222222211222222221211111111111111121
111111212122222222222211221111222122211122222111111111111122211121112221222122111112212211222222222221212222112222222222211222222221222221222222212221
122222212122222222222212122222212221222211111111111111112211122221222111112221122221122111111111111111211112212222222222211222222221211122211211212121
121111112122222222222212111111111111111211222222222222211222211211211122122121221121221222222221222222212221111111111111111222222221212211121211221221
122212222122222222222212212222222222221211222222222222213221212211222212221212212121211211112122112121112121222222122222221222222221211222221221122221
121212111122222222222211212222222222221221222222222222211222112111111221222212122121213222112212112121222121212212211122121111111111222121121122211121
121212211122222222222211212222222222221121222222222222212212222222222121211112121122211212221212212212211121211221222221121222212222112121223122122211
121211222122222222222212212222222222221121222222222222211111111111112121221222121111112211111211221222222121221121111112122111222112112212221212221221
121221112122222222222212112222222222221121222222222222211222222222211221112211122222222121222211122111112122222122222212212221111222222222122211111121
121122221122222222222212212222222222221221222222222222211222222222211212122111111111112121211122122222221111111111111212221121222111111111111122222221
122211122122222222222211212222222222221211222222222222211222222222212211221212222222212221222212221111122212222222211212122222212211222222221221111221
121222212122222222222211212222222222221211222222222222211222222222212121211212222222212112111211111111111212222222211211111111111211222222221212212221
122111122111111111111111211111111111111221222222222222211222222222212212211212222222212222122212222222221212222222212212222222221221222222221211222121
112122221222221111122222221111111111111121222222222222211222222222211212122212222222211112121112222222221212222222212112222222221121222222221211111221
122121221211121222221112121222222222222121222222222222211222222222211212121212222222212222121112222222221212222222212112222222221221222222221212221211
111221212222112211112212211222222222222121111111111111111222222222211212212212222222212111122212222222221212222222212212222222221211222222221222121221
122212212112222222222121221222222222222122221222222222221111111111112211212112222222212122211212222222221212222222211212222222221221222222221211121121
121112112111111111111111121222222222222121121211111221212112222122212112212212222222212212212212222222221212222222212212222222221121222222221222122211
121222122122222222222221221222222222222122212212221121211222112221212112111211111111111222122112222222221211111111112112222222221121222222221112211221
122111221122222222222221211222222222222121112111121122211211221112212112122212222111111111221212222222221221222222222312222222221121222222221221221121
112112212122222222222221211222222222222122222222222211122211222122112112221222112222222222211212222222221122111211122111111111111121222222221211212221
132222112122222222222221211222222222222111111111111122221111212221112221112111111111111111122212222222221212212211221211222222122221222222221222212121
112111112122222222222221211222222222222112222222222121212222211112221121112121111111111121221212222222221211212221211221212212211211111111111211122121
112222222122222222222221211222222222222112222222222112211111221222122222222121222222222121221212222222221221211111222121212111122212112221222122221221
121111112122222222222221211222222222222112222222222112112222122211111111112121222222222121222111111111111121222221112121212122221112222122212221111211
122222122122222222222221211222222222222112222222222112222122211122221222122121222222222121212222222222222222111122222122212221111111111111111121221211
122211121122222222222221211111111111111112222222222121111221222221121122121121222222222121221111111111111112111111111111112111212222222222222121122211
121222221122222222222221222222222222122212222222222111111111111111221221221121222222222121122122222222222122122222222222112112212222222222222121112121
122111112111111111111111221122111111221212222222222112222222222112211212211121222222222121212122222222222121122222222222112212112222222222222122212221
112221222222222112122222112221222212211212222222222112222222222122122212122121222222222121212122222222222122122222222222121222312222222222222121211221
121121111121112122121112221221211222221212222222222112222222222121111212212121222222222121222122222222222112122222222222121112112222222222222121212121
122221222221122121122221121212212113121212222222222112222222222122221221222121222222222121221122222222222112122222222222122122112222222222222111212121
122111211111221222212211122212122111121212222222222112222222222121122122112121222222222121212122222222222122122222222222112121212222222222222122212121
121122231222211131211222212232221222121212222222222112222222222121212112222121222222222121212122222222222121122222222222122122212222222222222121122121
122212212211122212221111211212112212112211111111111112222222222122212111111121111111111121222122222222222122122222222222121211212222222222222121121221
111222122112221222122221221122112112222121222221222212222222222112212222221111111111111111211122222222222112122222222222122212211111111111111122122211
122111221222111111111111121122212122111122212211211212222222222121221111122222122221111111221122222222222122122222222222121122122222122221211112121111
121212212222112222222222122221122121122222221222221212222222222122121121221112121121222221121122222222222121111111111111121121111212121122122222122221
121122122112112222222222121111221121121111121111111211111111111122222221212222121121211121122122222222222122211222222222221122222212221112121111211121
122121121122112222222222121121212221122222212221222221122222222221131221221112221221221221112111111111111121222211111122111111111111111222221222222121
112121221222212222222222122221212112211111212112212212221111111111111111122212121111121211222122111211111111111111111112122212222222221211112212111121
122122111211212222222222111112212222122211212212112212112212222222222222121212112222221222211212222122222122222222222212221212222222221122222112222221
121212212212212222222222111122122111221211211212212122111212222222222222121212212111111111111112112121112122222222222212212212222222221121111111111111
121211222122112222222222122221211222211222222211221221122212222222222222121221122112222222222212112122112122222222222212112112222222221322212222222211
122221111221212222222222121221222211111111111111122211221212222222222222111121121212222222222212112212212122222222222212212112222222221121212222222211
121122112211212222222222122112221212222222222221211112211212222222222222122221221212222222222212221222212122222222222212122112222222221122112222222211
121212222122212222222222112222111212222222222221222222121212222222222222121121211212222222222211111121122122222222222212121212222222221212112222222211
122211111121211111111111121111222112222222222221211211221212222222222222122212211212222222222211222122121122222222222212122212222222221212112222222211
112221221222111122222111121222212112222222222221221212212212222222222222121212122212222222222212212112122122222222222212122112222222221212212222222211
121122122232222212212222121212112212222222222221212212112112222222222222122112211212222222222212112221212122222222222212112112222222221221212222222211
112212211212111221211112121212211212222222222221212122112112222222222222112221222212222222222212211121122122222222222212122112222222221122212222222211
122111222112211121212212122221212212222222222221112121222211111111111111121121112212222222222211221121121122222222222211121211111111111322111111111111
121222112221212221221212211312212112222222222221222122111211211222222122221122221211111111111111122122122122222222222212221222222222221121222221222211
122212212112212111121212222122112211111111111111211112122222122211112211222112112222222221112222212112212111111111111112112221211122112222112121111211
121121222222112222221222112221222222222222222222212222221312221122222222212212222111111122222111222122222222222222222212222111222212222112222122222211
111111111111111111111111111111111111111111111111111111111111111111111111111111111111111111111111111111111111111111111111111111111111111111111111111111
