111111111111111111111111111111111111111111111111111111111111111111111111111111111111111111111111111111111111111111111111111111111111111111111111111111
122222222222222221111111111111112222222212222222211222222112221112221122212222122222221222221222212221222222222222222222122222222111222222211112222221
121111111111111122212222222222212112211221121111122212212112122221122221222112221122121211122211222122221111111111111112121212212122211121122212111121
121222222222222111212222222222211222121121121222221122122122111122112111111111111112121221111111111111121222222222212112211211211121121122121212222211
121222222222222121212222222222212211322221122211222121121121222212212112222222222122122121222222222221121222222222212211221221222121122112221222121221
121222222222222122212222222222212122121113111111211221122221121221212112222222222121112121222222222221221222222222212221121122122222112221112111122121
121222222222222111212222222222212121221222222222122212211111221112212212222222222122221121222222222221211222222222212122121222121112222122222222211121
121222222222222112212222222222212122212212111112221122222222212122121212222222222111121221222222222221211222222222212112121112212221111111111111212221
121222222222222112112222222222212111221122122211111221122112112221121212222222222122221211222222222221221222222222211222122221122122112222222212212121
121222222222222112212222222222212221121121221222222222212221222212221212222222222121121221222222222221121222222222212211311122221222222111111211112121
121222222222222122211111111111112121222221111111111311221122211211221212222222222121221121222222222221121222222222212122222211111111111111111222112121
121222222222222111111111111111222122112111222222221111111111112212211212222222222121211221222222222221121222222222212121211221222222222222212112222121
121222222222222112222222222221212112112211222222221122222222212112122212222222222121221211222222222221121222222222212221222111222222222222212211111221
121222222222222112222222222221122122111211222222221122222222212212221211111111111122111211222222222221121222222222212113112221222222222222211211121211
121111111111111112222222222221121121222231222222221122222222211221112222222222222212221221111111111111221111111111111122221121222222222222212222221211
122211211312221212222222222221121122111211222222221122222222212122211111111111111111122122222122111111111111111222212222122221222222222222212121221211
121222122222122212222222222221121212212211222222221122222222212211221222222222222212221121112112122222222222221211222112211121222222222222212122111221
121112121221221112222222222221221221221221222222221122222222212221121222222222222212112221212222122222222222221212211111111111222222222222212111222121
121222122121222112222222222221211121121121222222221122222222212121121222222222222212112121221122122222222222221211112222222211222222222222212122212221
121211112122112112222222222221212221221221222222221122222222212121221222222222222212112122122222122222222222221222112222222211222222222222212121121111
121222212112212212222222222221222111212211111111111111111111111121211222222222222212212212111112122222222222221212212222222211222222222222212121221221
121111222121211111111111111111111112211112222222211111122212222221211222222222222211221221222212122222222222221211212222222211222222222222212122222121
122221111221222222222221222222222222112221111211222222221212121112211222222222222211211122212221122222222222221221212222222211222222222222212211112121
111122122211111111111212211221111111222122221222121111111222122222121222222222222212222211122121122222222222221112212222222211222222222222211222212121
122212211212222222212221122211111112211211121211122111111111111211221222222222222212111111111122122222222222221112112222222211111111111111111221212221
121211211212222222212122121122222212112222122122211122222222211211211222222222222212122222222112122222222222221222112222222212211111111111111121211121
121211222212222222212112122221111222122121112221222122222222212211211222222222222212122222222122122222222222221211111111111112221222222222222121122221
121221111212222222212122121111222112111322211112112122222222212122221222222222222212122222222121122222222222221222212222222212121222222222222121121111
122112221212222222212122211122212112221121213122112122222222212211121222222222222212122222222122111111111111111221222111121212121222222222222121221221
122222122212222222212211222121212221121121222221222122222222211221221111111111111112122222222122211112222211111111111111121221221222222222222121212221
121111211112222222211221112221221122122212112111212122222222212122221222212221222222122222222121212221111212222222222222122122221222222222222121222121
122211222212222222212121111111111212111211222112212122222222212111122211212121212212122222222121211122211212222222222222112111121222222222222122111121
111212112112222222212121222222221212221211212212111122222222212211111122212121212122122222222112222211222212222222222222112211121222222222222122222121
121212122312222222212121222222221221121222211212222111111111112222221221122312212212122222222122121122111212222222222222121212221222222222222121221121
121222222111111111112121222222221211122111122221112222122222222111122212112122121212122222222121222221112212222222222222112212111222222222222122122221
122111112122222222222121222222221222212221111111111112211111111111112112222221121221111111111122131221222112222222222222122212111222222222222112211111
122222212121122111211121222222221121221121222222222211221222222222112221112212222122222122222112111112211112222222222222121212221222222222222121221121
121221122112221221221221222222221121121121222222222211121222222222121122112122112112212121212212222222122212222222222222122121121222222222222121122221
121212222212112211212221222222221122212221222222222212221222222222122212212221222112112211211111111111111212222222222222112121121222222222222122211221
121222131222112211212121222222221222122111222222222212111222222222121221211212211222121212212222222222221212222222222222112121121111111111111121212121
111111111111111211212211222222221212121221222222222212111222222222121111221221112211121222112222222222221212222222222222122122221222211222221111222121
112222222222221212211221111111111211221211222222222212221222222222122221121121222122221112112222222222221211111111111111121221111211222122121222212121
112222222222221222122122221222222222222231222222222211121222222222122122222212211221122112112222222222221222222222222222121211221211112221222211122121
112222222222221212222211122111111111111211222222222212221222222222121211131222122211221222112222222222221111111111111212221221212222111111111111121121
112222222222221121111212112122222222221211222222222212111222222222121221111111111221211211212222222222221122222222212211112121222112122222222221221121
112222222222221221111212212122222222221221222222222212211222222222122121222222221121221221212222222222221122222222212112221221111222122222222221112221
112222222222221212222211212122222222221121222222222212221222222222112121222222221121121122212222222222221122222222212112121212222112122222222221222111
112222222222221212111111212122222222221221222222222212121222222222122221222222221121121211212222222222221122222222212212121222112122122222222221211121
112222222222221212221122212122222222221211222222222211221222222222121111222222221322122122212222222222221122222222211212122111222121122222222221211221
112222222222221212112221122122222222221211111111111111211111111111122211222222221122212121111111111111111122222222212212112222211122122222222221222221
112222222222221212222211121122222222221222222222222222211311122222111211222222221221212121122211222221221122222222212122121111122212122222222221111121
112222222222221211111212221122222222221121111111111111122222212212111211222222221212211221221222211121122122222222212121122221121222122222222221212221
111111111111111222212212112122222222221221222222222222121211222212221221222222221212111211112212112222212122222222212122221122221112122222222221222111
122221111111111112122112112111111111111211222222222222112212121211122121111111111212222222212112212131222111111111112111111111111111122222222221221221
121121222222222112121112222222212222212211222222222222122112221122212121222221211111111111212211211111111111112221222122222222222221122222222221212221
122211222222222112122211111211112111212111222222222222121222211121221122211122112222222221221221211222222222122122212122222222222221122222222221222121
121211222222222122111212221222222212212221222222222222122122122221121111121112112222222221122111221222222222121211122122222222222221122222222221111221
112211222222222121221221122111113112121121222222222222112121121112122222122222112222222221212221121222222222122112221122222222222221111111111111121211
112121222222222122222122112222221222122121222222222222112121221222111112222111212222222221211122221222222222112221122122222222222221222111211131221221
132221222222222122112112112211121211212121222222222222122111211211111111111111112222222221222111121222222222112122212122222222222221212222122222222121
112121222222222122211222112122121221222221222222222222121222212212222222222222112222222221212111221222222222112122122122222222222221211112121121212121
112121222222222121222211222121122121111211111111111111122211112112222222222222112222222221212122211222222222112212211122222222222221212122121121211221
122121222222222122111131122122222122222112221112221111121112222112222222222222112222222221211221121222222222121221221122222222222221212121122121122211
121111222222222112212222222211111111112112122212122222222222122312222222222222112222222221222212221111111111122121122122222222222221222121112122121121
122221222222222121211121111212222222212212211211111111111111212112222222222222112222222221221112122221222222112122112111111111111111122322222112122211
122121222222222121222221222212222222211211211221222222222221222112222222222222112222222221212222112112211212222112212222111111111111111121111112111211
121221111111111121111112211112222222212211222121222222222221211212222222222222112222222221221221212221211211111122212211122222222222221221222212222211
112211222222222122222112122212222222212112211221222222222221221212222222222222112222222221122121211121221222222221111222122222222222221212211221111121
122111211221111222112212122112222222212222122211222222222221122212222222222222111111111111222221222222111111111111222112122222222222221212122122222221
121222212122122212211122112212222222212211121111222222222221121112222222222222112222222121111111111112122222222221212222122222222222221212212211111221
121211122312221121222222211212222222212112122221222222222221122112222222222222122111212121222222222212122222222221211112122222222222221211211222222121
122212222111111111111111221212222222212222111121222222222221212112222222222222121221212221222222222212122222222221222212122222222222221221222111221221
121111212222122222222221121212222222211121122221222222222221212112222222222222121211221221222222222212122222222221211212122222222222221122112122221211
121222231112122222222221221212222222212221221221222222222221212211111111111111121222122121222222222212122222222221111221122222222222221112222121121221
121212211112122222222221222211111111111111212121222222222221211221222222112211122212212211222222222212122222222221222122122222222222221221111221221121
122112122221122222222221111122221131222222212221222222222221222222211112222122211121211211222222222212122222222221212212122222222222221211122212211121
112212221121122222222221222212122222212111121121222222222221211111111111111221221112231211222222222212122222222221211212122222222222221222221221112221
121211112221122222222221211222112121112211122221111111111111212222222222112211122221211211222222222212122222222221221222122222222222221122112122112111
121222212122122222222221222111222112221122211111222222112222112222222222112122211121211221111111111112122222222221121112122222222222221121222212212221
121111221112122222222221212122211222121221212222212212112112212222222222112112221121212122222222222112122222222221121222111111111111111221211211221121
121222122212122222222221212211122211122211222111121212212211212222222222112212122121212111111121112122111111111111121211122221122222211211221222122121
121212111222111111111111211222221111111111111122211221112122212222222222121222111221222222221221222121222211122222221222221122221121212222111221112221
122212112211222221222222122111111212222222222111212121222121212222222222121211222211111111111211111221211122221121111111111111112221122112221121221211
122112112122211121111212121222112212222222222122222122211221212222222222121211211212222222221212221211212221112221122222222222122112122221122222211221
111222112221122222212212122212222212222222222121111111121211212222222222122211211212222222221222122211222111111122122222222222121122121111111111111111
122211111111111111222112122112211212222222222122221222221221211111111111122121212212222222221211111111111112222112122222222222122221121222222222222211
121112222222222221111212122212112212222222222111122211221122122222222222222221212112222222221221222222222212112222122222222222112112221222222222222211
121112222222222221222212211212122112222222222122211111212112211211111111111111211112222222221121222222222212112221122222222222122122111222222222222211
122212222222222221211221212212121212222222222121222222221221211212122222222221222212222222221221222222222212122121122222222222111221221222222222222211
121212222222222221221121221122121212222222222121111111122211221212122222222221211212222222221211222222222212211221122222222222122211211222222222222211
121212222222222221121122121121121212222222222122221112212231122212122222222221211212222222221211222222222212221212122222222222121121211222222222222211
111212222222222221122211221121122212222222222122122212111212211112122222222221211212222222221221222222222212121222122222222222122122231222222222222211
122212222222222221221222222222211112222222222122211212221212112222122222222221122212222222221121222222222211221112122222222222112211211222222222222211
121212222222222221212111111111111112222222222121212211122222222112122222222221121212222222221121222222222212212222111111111111111221221222222222222211
121212222222222221212212222222222111111111111122122121111111111112122222222221121212222222221121222222222212121111111111111111222122121222222222222211
122112222222222221221212222222222122222222222211221121222222221222122222222221121212222222221121222222222212211222222222222211212112121222222222222211
112112222222222221122212222222222112211111111112211221222222221211122222222221221211111111111121222222222211211222222222222211212222221111111111111111
122112222222222221211212222222222122212222222212122221222222221222122222222221211131122222112221222222222211221222222222222212211111111111111112221221
121212222222222221221212222222222121212222222212212121222222221112122222222221222222211212212121111111111111121222222222222212111222222222222212122121
122111111111111111222212222222222122112222222211212121222222221212122222222221111221211211221222122221122222121222222222222212221222222222222212212221
122222222222122221211112222222222112212222222212212211222222221212111111111111222221221212122112211212221112221222222222222211121222222222222212221121
121112121112211221222212222222222111212222222212121211222222221212211212221222211122111212112121222222111222221222222222222211221222222222222212122211
111312112221222211111212222222222122212222222212211211222222221211222212122112212122122212112121112211222111121222222222222211211222222222222212111211
122222122122111122221212222222222121212222222212221221222222221211111212112222112221221122122121122212212211221111111111111112211222222222222212121211
121212121212222221122212222222222121212222222212122121111111111222211212211111122212212222121122221122111211211112222111222212121222222222222212221211
121221221211111112111112222222222121112222222212112121331222121211211211222122121112122212122211112221222212222222112222211112221222222222222211121221
121111212211122212222211111111111122212222222212112122222212221211221221112212222212221211121211122112212111111111111112112221221222222222222212221121
121122211222221222112122122222222211212222222212112112221122111212122121211221131221121122211212221122122122222222222212112122121222222222222212112221
121121111111111121132221121122111211211111111112112112121111222212112221222122211111221121222212112121121122222222222212212112221222222222222211222121
122221222222222122212112221221222222212222122111222122112222211132221111112111222122212122112212212122122122222222222211212111111222222222222212211121
121111222222222111212222111211211312222112212222211121222111112222122222222222112221112212221211212212111122222222222212212221221111111111111112112221
122121222222222111221111111211211111111111211122112222211312221121122111111112111112221212212211211212222122222222222212121121121211222212221222112111
112221222222222122121112222211212222222221222221112121122222122211121221122212222212122211212221212211112122222222222212212121222122211221121212212121
121121222222222121221222111111212222222221111112221221221211221222121212221211111221312221211111222122212122222222222211212122212221121122122211212221
121221222222222121211211222221212222222221222122122121112211222112221222111222222122222121222222211121222122222222222211222311121112222212211122211111
121211222222222122221222211122112222222221212221212122212122111111111112122121112211211111111111112221112122222222222212112122222212112121211221122221
121221222222222111111111111112112222222221221112112211222112122222222112222122221212212222222222122112212122222222222211212111211212122121211211221121
122121111111111112222222222212212222222221122212221222111222122222222111112211122112112222222222121222112122222222222212212222211221221222211222212121
112122122222112212222222222211212222222221211221221211222212122222222122211212212212212222222222121122122122222222222212121111112221212211111122122121
122212121212122212222222222211212222222221222121211211211212122222222121221222221221212222222222122212221122222222222212221222221121212111222212222121
121112121212121212222222222212212222222221212122211221212212122222222121122111121122212222222222121221111111111111111112111212121221212122211211112121
122222121212121212222222222212111111111111221112112121221122122222222122212211122111112222222222122122222222211122222222222212112212212221122212222121
122111121212221212222222222212111122122211222212222122122121122222222121211222212211212222222222112211221111122211111113111112222222111112221112111121
121222211221111212222222222212222211221222211222221212112122122222222122122111221222212222222222122222122222221212222221111111111111222222112222222121
122211221122211212222222222212111211211111111111121212112212122222222112121222121111212222222222121111111111111222111121222222222211211111111111111121
111112121121222112222222222212121221221222222222121212221221122222222122122212122222212222222222121222222222221211222221222222222212212222222222212221
122222121122112111111111111112122121121222222222122221121121122222222121322122211111112222222222121222222222221111211121222222222212112222222222212121
112211221211222312222221222122112121121222222222112211221121111111111122121221222111211111111111121222222222221222212121222222222212212222222222212121
111211211222212122122122122121112121221222222222112211212222212222222212211212211222212222112221211222222222221211132221222222222211212222222222212121
122211211221122121212212221221222122211222222222122122211211112111221221221212112212221112222121221222222222221222212111222222222211212222222222212121
121221222212221122211221112212211111121222222222121221122212222111122122122212222121122211211221121222222222221221212221222222222211212222222222212121
121121111112111111111122222121222222221222222222112211222112111222112111111111111111211211211211121222222222221211211121222222222212212222222222212121
122122222112122222222121111121122121221222222222112122212112112212212212222222222221211212212222221222222222221111222111222222222212112222222222212211
112111112212122222222121222222211221121222222222122121112222222121111212222222222221222212122111221222222222221222112221222222222212111111111111111211
122112221112122222222122111221222212221222222222121111111111111112221212222222222221221112211222121222222222221212212121222222222212221122222222221211
121222122222122222222112222211111122121222222222122122222222222212122212222222222221211221212212211111111111111221221121222222222211121221121111121221
121211211111122222222121211122222111121222222222112122222222222212112212222222222221222121222121222222212222112122121121222222222211221222122122222121
122211222222122222222121212221112222121111111111122122222222222212121212222222222221112221122211122111221212221212122121111111111111211111112211112221
121221121122122222222121212112221112122112222122221122222222222212121212222222222221121122121122212111122211121212112121122222222221222222212222211121
112121221121122222222122212112122212212221221221112122222222222212121212222222222221222212112221212122211122121212112222121111221121111111212121211111
122121112222122222222111132221111211221122211212222122222222222212122211111111111111211122122111212121212221121212221112122121211221222211211221212221
121122221112111111111122212122211221121121112211222122222222222212122111222222222122221221121212212221221211121221122211112121212222121221222111222121
122211121112122222222221221111212222221221222122212122222222222212121122211112112211121211221222122211121222122122211212222121221112122122112222111121
121221121222212112211111122222212111112211211221212111111111111112121221112222111222221221212211221122221212212112212212111221122212212111111112222221
122122122211212122122222111111122111222112212212212112222111222212122211122111222111121122212121212221112211222122122212222222111221222122222221111221
122212211121211121221112111222221222111222122111122112112122211222111122121221212211221111112122212112222122111121221221111112122122112121122112222121
121221222221222221211111222211112212212211121222211112112121122112222112222211221221211222212211112212111112222221211112222212112212212121221222112221
122122111111111111212222212111222122222122121211211222112222112221112111111111121121112212122222211212212221221121222222122112211211221221212211121111
112212222222222222222111122222211221311212222211222211221112222122212222222222222122222112221311222211222122212222111111212222222222122211222222222221
111111111111111111111111111111111111111111111111111111111111111111111111111111111111111111111111111111111111111111111111111111111111111111111111111111
