111111111111111111111111111111111111111111111111111111111111111111111111111111111111111111111111111111111111111111111111111111111111111111111111111111
121222222222222222222211111111111222122222221122222222212221122222112211111222222221222122222122111111111111111211131222222222122122221222222222221121
121211112111111111121112222222221221221211112221112211212122211112221122222111121121212112212112122222222222221222222211112112121221122212121211122221
122221222222222222222112222222222222211221222112222121212111221111122221112222221221212212112222122222222222221111121121122122121212211122122122211121
122112212122222222222112222222221211122122211222111322212221122221111212122111112222211222121112222222222222221222212212221121222222221121121221221121
121212122222222222222112222222221122221111121122122121122121111122222212221111111112111111121112122222222222221211222122111122111111121221221212122121
122212121122222222222112222222221121211222212221222221121122211111111111112122222222222221222222122222222222221212111221222112122211221212212212212211
112212121122222222222112222222221121222211222112212112121211212222222222212122222222222221211111122222222222221222122211212112221212211221122221211221
121122122122222222222112222222221121111111211111122112122211212222222222212122222222222221222222122222222222221122212211212211111221212122222112222121
112221212122222222222112222222221121222222222222121222221122212222222222212122222222222221111112122222222222221211211221211221222121222111112222112121
122111212122222222222112222222221221222222222222122122111121212222222222222122222222222221221112222222222222221212222121222122112121122221111111121221
121222222122222222222112222222221211222222222222112111222121212222222222212122222222222221212222111111111111111222112221212112112122212212221222221211
121211111122222222222112222222221221222222222222112221212121212222222222212122222222222221212111122122222111111211111111112112222211221212122211221221
121212221111211111111112222222221121222222222222121121212121212222222222212122222222222221222122212121112222222222222222212211122111122112211121121121
121222112222222111122211212111211121222222222222121221212221212222222222212122222222222221221221222122221212122222222222212221222122212121222122121121
122121222111212222121222222122211121222222222222222222211112212222222222212122222222222221112212112211121221122222222222212122112121212221212112221221
112121211221221112111122112111222121222222222222121311111222112222222222222122222222222221222122111221221122122222222222212112112112231222112112112221
112112211212121222122221112222122221111111112111122122221211212222222222212111111211111111211121222122211212122222222222212212122122211112122112112121
112112222222121211121112211112121121222212222221222121121221212222222222222112221222222121212122212211112212122222222222211112122221222212221112212211
122122111111121222121122222212111121211122122112211221122122211111111111112222122122112221212121111212222112222222222222212222112111111111112211211221
121122211222221112221121121122122221222222212112111212212121122222212222212111112212221111212221222222122122122222222222212112122222222222211211222121
122221122211112111112221122221221111112111112222221222112121221121122111222122211222112221212211211111112121122222222222212112122222222222213222112121
111122121112221222111112221112221222222222121111121211112121212222222222112221221111222121212122211222222121111111111111112122122222222222211211122121
122211221222121212222211122222121222222222121222212212222111221111111112111112122212211121221221121211111221111111111111222121122222222222213222121121
121222211211122211111222111111121222222222121211222112111222121222222222212222211222222122222212221222212221222222222221211121122222222222211212221221
121111122211111111111112122221221222222222122212111212222212222222222222211111222111111111111112112111212121222222222221222122122222222222212211111211
122221221112222222222212212112211222222222122112222211111131111222222222212222112122222222222212221111212122222222222221112112122222222222212112222231
122122222112222222222211212112121222222222221111111222212222211222222222222112112122222222222212122222212121222222222221122122122222222222212122111211
121211312212222222222211212212221222222222221222221211222121221222222222212212212122222222222212211111112111222222222221121221122222222222212122112211
122211111212222222222212211221221222222222122211122111111221121222222222211211222122222222222211212221112221222222222221121212122222222222212212212121
112212221212222222222222122211121222222222112122222222222212121222222222211211212122222222222212212122221122222222222221221212122222222222211221212221
122212121112222222222212121222121222222222112111111111111122121222222222211211221122222222222211112121122121222222222221212212122222222222211122112111
121122122212222222222212211212121222222222112122222222222121121222222222211221121122222222222212222121112222222222222221212122122222222222212212212221
111221111222222222222211211212221121111111122122222222222122221222222222212121122122222222222212121212222111111111111111212121111111211111112121221121
122212221212222222222211212211112222221222121122222222222121111222222222212222211122222222222212121212111122222222222222212122221112221222222221121121
121112121211111111112112212122222111122112122122222222222121221222222222212211222122222222222212112222122121121111111111112122122222122122111111121221
122112122211112221222122112212211222112112212122222222222122121222222222212122112122222222222212112111121221121222222222112212211111112221222222221211
112112111122222122212221221221212221222222212122222222222112221111111111112121122122222222222222112112221212221222222222111212221222211121211111111211
112212222121121111111121212221212121211111212122222222222111211111111112222221222111111111111112212222121212121222222222122212121211222121222112222231
121211112221222222222121221122212112212222112122222222222112222222221222111111212221222222111221221111212212211222222222121122121211111122112122111211
122222221111222222222112222211112212112112222122222222222112222222221211222221211122112112222222122222112121221222222222121221121222222222212221212211
122111122211222222222112111212221222112121111111121121111112222222221212211122212212221222211112111112222122122222222222122112221211111111112111222121
121112211211222222222122111222121221122122222221222222211222222222221212122111122211121122122112122221111212121222222222112122112212222222222213221121
122221211211222222222121222211112212121122112122112221212222222222221212122222221221221221222222221122221122121222222222122121212112222222222211212221
111121221211222222222121211122212122121221212112112121222112222222221122121111122121211212211111111111122221221222222222121221212112222222222222212121
122122121221222222222121212221212221221211212212222112122312222222221121222222212211212212221222222222111221211222222222122212212212222222222212122121
121212121121222222222121222112211221211211221221111122112112222222221121211111211222222111121222222222121121221222222222111122221212222222222222121221
121212121221222222222122111122121221211222222121112221122112222222221121112221221111111222121222222222122221121222222222112221112212222222222212221211
121222221211111111111111222221122212222111112122212111121212222222221322212122112222222212211222222222122113121222222222112122122112222222222211112211
122213111222222211122222212112222112111111111111212112221211111111111121212112122111111111221222222222121122221111111111122112222212222222222212222121
111111111111111222121221121222111122112222222211212222111212221222222211212212121222222222221222222222121222121222111222222221131211111111111112111121
112222222222221112121121121211122221212222222212212211221222121211111222211212221111111211121222222222121212111212221211131111111111111112221122111221
112222222222222222122122222221221112212222222212112111122211121211111111111221111222222222121222222222221211222212122112222212222222222212122221222211
112222222222221211111121111112212222112222222212122222121211221212222222221222221222222222121222222222121222211122112222121212222222222212111111111221
112222222222221211222222222212112122112222222212111112121211212212222222221211121222222222121222222222122111111111111111221222222222222212221222222121
112222222222221221222222222222221222212222222212222122212211211212222222221211221222222222121211111111112212222222222221211212222222222211121211212221
112222222222221121222222222211121211212222222212112211212121222212222222221211211222222222121222222222121212222222222221111212222222222212121221221111
112222222222221121222222222212121221222222222212221221222121111212222222222221211222222222121211221112121212222222222221222212222222222212122122112221
112222222222221121222222222212121111212222222212121121111222212212222222221121211222222222121122211222121212222222222221211212222222222212112212212121
112222222222221121222222222212222222212222222212212221111221122112222222221221211222222222121121112211221212222222222221212212222222222212221221222121
112222222222221222222222222212111221212222222211212112221121121212222222221211221112211112121221212122121212222222222221212111111121111212122122111221
112222222222221211222222222211222121211112111112122122121221122212222222221222121222222222222211222112221212222222222221221122211222222222212112211211
112222222222221211111111111112212122122222221111221221121212212212222222221111221211111111111111112211121212222222222221122221122211121111112131222231
111111112111111222111222222112122112111112122222211212222221211211111211111222212211222122222222211221221212222222222221121111221112222222212222111211
121112222222221212222211112222122212222112111111122211111121211222212222212211112122212122222222212121211212222222222221122122212212222222211221122211
122222112111121221211111111111221121112112222111121122221122212121122122122122112221122122222222212121222211111111112111112121111212222222212212221121
121111222121121111222222222221211222212211112122221221122212222122212212121222211223111122222222212122122122211111222211222121222212222222212112111121
122211211122222222212222222221221211211222222121121212212221112111211212121212222221222122222222212112121121222222111222211121221112222222222122112221
121211211111111112112222222221122211211111211111121222122121222112211112122122111111212122222222222222121221111112221121211121122112222222212121212121
122122212222222222112222222221211112211222222222121122311121211122122222112121122222212122222222212211221211222221122211222122212212222222212221222121
112121112222222222112222222221221222121222222222121222122223122222112212212212221111122122222222212112211212211122111211112111211212222222211111211121
122122212222222222112222222221121211121222222222122211121121221112222122221222112222121122222222212122112212122212213222112221212212222222211221221121
121111222222222222112222222221121222221222222222111122221221212221111121111111222112122122222222222122212112111211221212122212212112222222211211121121
121222212222222222112222222221122111121222222222122221111211222121222222222221211222312122222222212211122122222222122212221212112212222222213222121221
111211212222222222112222222222212222121222222222121111222222111221222222222221221212122122222222211222121211111111111112111112221211111111111212121211
122211212222222222112222222221211121122222222222122222111112121211222222222221121122222111111211112112122112222222222222122221122212222222222212221221
121122212222222222112222222221222221121222222222121112122212121211222222222221122213112222211222212112112112222222222121121122211221212111111111222121
121221212222222222111111111111212212221222222222121112221212221211222222222221211221211121122211212222212212222222222121221211221121212222222212212121
122112212222222222122222222122211212111222222222122221111211112211222222222221122121222221221112211111211222222222222121212222121221212222222222221221
122212112222222222121111112121221122121111111111111122221222222121222222222221222122122111212212122212211212222222222121222112122212212222222222112221
121221211111111111121222211221121221121222222112111111111111112221222222222221212212121222212112221212221212222222222112211222111122112222222212112121
121122122222122211122211211211122212222212212222122222222222121121222222222221221112212211122211111221122212222222222122121111111111112222222211222121
121112121112221222222221222222111111111211211111122222222222122121111111111111122221222122221222221122111212222222222121222222222222112222222211211221
121222122121211111111111111112122222222221222221122222222222112121222111111111121221111211221111122112211212222222222122221222222222112222222211211211
112211112121222222222222112222122222222222212122122222222222122121122122222222111212222122212222112221222112222222222111121222222222112222222212211221
112122212221222222222222112111122222222221122212122222222222121122121122222222122222112221122112211122112211111111111122121222222222112222222212111121
122121221121222222222222112221122222222221121122122222222222122212122122222222121111111111111111222222221222212222221121121222222222112222222212222211
121122112221222222222222121121122222222221221222122222222222121212112222222222122122222222222221221113122111222122122221221222222222112111111112111221
122112222121222222222222122221122222222221211212122222222222121222112122222222112222222222222221212211121111111112111112211222222222122222222211111121
122211111221222222222222122112122222222221221212111111211112122111122122222222112122222222222221212112222222222212112222121222222222121112111212222221
121211222111222222222222121221122222222221112212212221222122212212221122222222122222222222222222212212222222222212212111221222222222121222111222111221
111212212221222222222222121122111111111111122121222122212221221221122122222222121122222222222221211212222222222211222122221222222222121211222111222121
122212221121222222222222121112222211122222221221121111111111121122112122222222121122222222222221222212222222222211111112121111111111111213221122211221
121112121221222222222222122211221122211212221221221222222222222112222111122111122122222222222221111212222222222212222222122221113111122211222221221211
121122212211222222222222111222122221222212122121211222222222222121112122222222112122222222222221212212222222222212121221222112222222221122211112121211
122121122121222222222222121112212111111112211221221222222222222121112211111112222122222222222221212112222222222212122121112212112111111111111111122211
122221121221222222222222122221212222222211221211122222222222222112221222122221121122222222222221222112222222222212212212221212221122222222222221322111
121111221211111111111221112221222222222211121222221222222222222112122112121121121122222222222221222212222222222211212222121211121122222222222221121221
121112211222222221122221122121212222222212221211111222222222222122122112121222221122222222222221211212222222222211212111121211121122222222222221121121
121222122112122122221122121121212222222212111212111222222222222111221222122111112121111111111111222111111111111111221221221222122122222222222221221121
121211112112112111111111222211212222222212112212221222222222222122212211212122222222221311221222112112222222221222122212212112112122222222222221212221
121212222222112212222212211212222222222212122221121222222222222121112112222111211111122222212212122122112111112212111212112212222122222222222221211221
111211112111111222111222211212112222222212111122221222222222222122112212112122222222112212212122121221122122222112112212122221111122222222222221221211
122212222222221221222111212212112222222212222111221222222222222112221211122122222222122111112121122122211121111212222122121122221122222222222221121211
121212222222221211212221212122111111111112212122121111111111111112121222221122222222121122222122112121211122122231111222122122122122222222222221221211
121212222222221221212122112121122211211112112112121111111111111122122111112122222222122221111212222121222112211222211212211112212122222222222221211211
122112222222221121212212112121121222122221222112122122222222222222212222222122222222121111312111111111112221221121221211122221221122222222222222221211
122212222222221221131212212121122112221121211112212122222222221211121211122122222222121122222122222222212111121221121222221122122111111112111111122231
121212222222221212222211122121212112112122211222222122222222221222221222212122222222121121212122222222212222121211111111111112112222222222222221111211
121222222222221212121111121121222112122111112211111122222222221111222111221122222222122211212122222222212212121212222222222212221111111121111122222211
111212222222221222312222221122111222121311212122222122222222221222112221121122222222111221221122222222212112122222222222222212122222222222222121111111
122212222222221112122111112222222211122222212121112122222222221211111121121111111111122122122122222222211112111212222222222212121222222222222122221221
121112222222221112121222111112111111111212212121122122222222221222222221122222222211222212112122222222212222122212222222222212121222222222222111121121
122112222222221222121212222222222222221221122121121122222222221211111111111111112122211212222122222222212111121112222222222212121222222222222121221121
122212222222221211122212122222222222221121121122211122222222221212122222222222212121121221112122222222212112222212222222222211221222222222222121212221
121211111111111122211212122222222222221221221111222122222222221222122222222222212122121121222122222222212222111212222222222222221222222222222122222121
121212222212221221222122122222222222221211212222112122222222221112122222222222212112223121211122222222211111222112222222222212122222222222222121111121
121212211112122211112222122222222222221222212112222122222222221122122222222222212211121221221122222222211222212222222222222212121222222222222112222121
112211212222111212221112122222222222221211122221122111111111111221122222222222212222221211121111111211112211111212222222222212121222222222222122111121
122122212111212212111112122222222222221222222111121111111112221212122222222222212111111222221222222221222121222222222222222212121111111111211121122221
121221212222212132222222122222222222221111112122222222222212121212122222222222212122211111112212211121212122211112222222222212121221111222221222221111
121211111112212212111112122222222222221222122122222222222211221212122222222222212211212221112111221121122121112212222222222212122122222211122122121221
121222222221221221122221122222222222222221121122222222222212211212122222222222211221222122222222121121121221222111111111111112211222111122212111122221
121111211111121121221122122222222222221121121122222222222212112212122222222222212121111111211111221122221222112212222221221112222211222121212122211121
122221222222221122222212111111112111111122221122222222222212112122222222222222212221222222222221211111111112221222121121121222111122212221212221222211
121122111211111111111212112222222122211221112122222222222212212112122222222222212111222222222221222222222211122111221122221211222221211111111111111221
121212122222222222221212222112212221212212222122222222222211222212122222222222212221222222222221212222222212212122212211121211111121212222222222221121
121212222222222222221221111221211112212121222122222222222211211222111111111111111121222222222221212222222211222221121222221212222221212222222222221121
121212122222222222221122121121222122112122212122222222222211221111111111111122211221222222222221212222222211111111111111121222111111212222222222221121
122212222222222222221222122121112211222112212122222222222211122222222222221121222211222222222221212222222211222222222222121111222221212222222222221121
121122122222222222221212212222111222112212122122222222222212222222222222221121111121222222222221212222222211222222222222121222122121212222222222221121
112221122222222222221121212112221112221222121122222222222212111222222222221221122221222222222221212222222211222222222222121212112111212222222222221221
122111122222222222221221222122122212211111122122222222222212211222222222222212221121222222222222212222222211222222222222121212212222212222222222221211
121222122222222222222212111221211221222222222111111111111111221222222222221222112221222222222221212222222211222222222222222211211121112222222222221221
122212122222222222221222122211211111111111111221111122222222121222222222221111112111111111111121211111111111222222222222111111222211111111121111111121
122122122222222222221211221111212222222222221121222221111221221222222222221122212111311222222222222122212221222222222222122222111222222211222122222221
111121122222222222221211212222212222222222221221211111222121211222222222221221212122222112111111312221222121222222222222221121111111111222212211212121
122221111111111111111221222111212222222222221212212222221221211121111111111211222121212112222211111121111111222222222222121222222222221111121222112121
121111222212221122221121111112212222222222221212112122121211212221111111111211221221212221111212222222222211222222222222121222222222221222221112222121
121222211222122121121122212222112222222222221212122112121222211121222222222221211112211121122222222222222211222222222222121222222222221211211221111221
121211122111212122121212112111212222222222221212121112121111122221222222222221212222121221121112222222222211222222222222121222222222221213222222212211
122212221222122212121222212221222222222222221212211222122221121121222222222221212111221211122112222222222211222222222222121222222222221221211121122121
111221222212121122122111211122212222222222221221221211211121221221222222222222222122211222112112222222222211111111112121121222222222221121211122121121
112121122111122221212111221121112222222222221212221212212221212211222222222221111121112112222112222222222212222221122122221222222222221111212212121221
122122212222211111212221121122112222222222221221122212122112212122222222222221222222221221112212222222222212112122212221221222222222221222212112122211
121211221111211112211122122212112222222222221121111132221222112121222222222221211131122212221212222222222212122121212212222222222222221211112222211211
121222121112222222122212111222111111121111111322222212112121222121222222222221222212121112122222222222222212121122122112121222222222221222112211112211
122211221222111112121212222111122221122222221121112122221221211221222222222221111222121122111112222222222212122111121212211111111111111212221112222221
121222222211222222221221112222221122221111122222212221122211222211111111111111222222122222222211111111111112212222222211222222222222222221122222113121
111111111111111111111111111111111111111111111111111111111111111111111111111111111111111111111111111111111111111111111111111111111111111111111111111111
