111111111111111111111111111111111111111111111111111111111111111111111111111111111111111111111111111111111111111111111111111111111111111111111111111111
122222111111111111122222221222222221112222122222221222112222112221131222221222222221122112221222112222211212222222222112222212222222212222222222222211
122212112222222221121112221211122122222111221111221212222112222112222211122111121122121222121212222111212212111221211222122122122111212111111111111211
121212112222222221122112121212212211111112212222221211111111122112122122212222121212122211122112211221212112212121122211121121212212212122222222111221
111212112222222221212112111212111221111222112111121221122222112122112121121112221222221122112222111211212211212122221122121122211212222122222222122121
122212212222222221212122122222222122222211122111322121121112112121112122211222211111111112211111122211221222222111122212122212231221111122222222121121
121111212222222221212121221211111111111111121222121222221222112221222121222211112222222211222122221111121111121222211222122112211122221122222222121221
121222212222222221222121211212222222222222122212121211111111111111211221111122212222222211122121122222122221221211212222212222122211121122222222122211
121211112222222221221221222112222222222222111112121211222222222211221222221221212222222212221221311112211122112211221111111111121222223122222222121111
121122212222222221212212112112222222222222122222121211222222222212121211121211212222222212121212222221222222222122121122222222121111121122222222122221
122221212222222221212112122112222222222222121111121211222222222212121221111211212222222212112211211111111111111122221122222222121222121122222222111121
122112212222222221212222121212222222222222122222211221222222222212221112221212212222222212122112212222222222221121112122222222121122122122222222122121
121222111111111111221112221212222222222222111112222121222222222212112112122212112222222212121222112222222222221122112122222222121121222122222222121221
121211122111111111111112111212222222222222111112122121222222222212112222311112112222222212221212212222222222221212122122222222121122112122222222121211
121222212122222222222212222212222222222222122221121221222222222212122212112222112222222212112211212222222222221212121122222222122212222111111111121211
121111222122222222222211112211111111111111121121122211222222222212221112212111112222222212122221212222222222221212122122222222121221111222212221122211
112222112122222222222212211211111111222221222122211111222222222212112221212122211111111112111112212222222222221212212122222222121122222112112121221121
112112222122222222222212222222222222211122112121112221222222222212212121212121222222222222122212112222222222221221212122222222121211112112122122211121
132221112122222222222212111111111111111112212212222121222222222212122122122122112111111121221212212222222222221211222122222222122211222122121111222221
112121222122222222222212212222222222222121211222111121111111111112121222121211122111222122211211212222222222221222112122222222111112211121221222111111
122121211122222222222211212222222222222121221112112221222212222211221112221222211222212112212222211111111111111211122111111111122212122122211212222221
121121222122222222222212212222222222222121122221222121211221111221212221112221211211122121211111111111111122221222121222222222221212212122112211111121
121122111122222222222212112222222222222122211122212112211222211122212122222111211212121122212222222222222121122212122111111212112211212221222122212221
122112222111111111111112212222222222222121222111122112122211222221212211111122212222121322112222222222222122111112112111222112122122211112211111212121
112211112221222122221111212222222222222121112211221222311122111112211221222121122111121121112222222222222112122112222222212222121122112222222222212121
111212221122212121222222212222222222222122211221211212122211222222122222212122221222121122212222222222222112212111111111111111121212112111111111112121
122222122211112212212111112222222222222121222112211212121222111111221111111111111212121111212222222222222121212122222222222211221222312122222222122121
121111111221221221112122211111111111111121112122111221121112122221211222222222221212122211212222222222222121212122222222222213222122122122222222121111
112222222222212122122211212222222212112222212222222121221212121121221222222222221212111211212222222222222121222122222222222211211222121122222222122221
112111111111111112211221222111211212221111111111111122212212221122121222222222221212111211212222222222222121112122222222222211212212121122222222122121
112122222222222211212122112221211221121222222222222121112111111212221222222222221212221221212222222222222121222122222222222211212111221122222222121121
122122222222222212212112212121221122221222222222222122222122222211111222222222221211121121212222222222222121211122222222222212212222212122222222112221
121122222222222212122211212212122111221222222222222111112221112231221222222222221212122121212222222222222121221122222222222212121111212122222222112121
122122222222222212121211221222112222121222222222222122221112221211211222222222221212122221111111111111111122122122222222222212212221212122222222132211
112122222222222212211222121111111122211222222222222121122112121221211222222222221212221111222221221222111222212122222222222211212121222122222222112221
112122222222222212221112122212221121221222222222222122112222121121211222222222221221112221211121122212222211222122222222222211212122111122222222122121
122122222222222212122112211212122211121222222222222112111111221121211222222222221122222122222122211211111111111122222222222212212112221122222222111121
121122222222222212212211222222121222221222222222222122122221212221221222222222221111111111111111221212222222221111111111111112122221122111111111122221
121111111111111111221221121211221111221111111111111121121121221122121222222222221122222222222221222112222222221222221222221112122112212221222222221221
121111222222111111111122211211111111111222221122222122212222122112221222222222221122222222222221212212222222221212211211121222112221221121111111212121
122222111212122222222121212212222222221211122221112211212112212211111111111111111122222222222221221212222222221221221211122212221122122222222122212121
111112222112122222222121221112222222221221211111121222212211221222222222222222222122222222222221112212222222221122122222211121122112111111112121112121
122221112122122222222122122212222222221121222222221111112221122111111111111111121122222222222221222212222222221111111111111111112212211222212221222221
112222112222122222222111111212222222221122111211112221122122212212222211222111121122222222222221211212222222221122222222222212221211211211111111111121
122212221112122222222122222212222222221212211222222121222211211211111222212222221122222222222221212212222222221122222222222212122222211212222222222121
121211111122122222222121111212222222221221222111221122111212211221222111111111111122222222222221221112222222221122222222222211111111111212222222222121
122122222121122222222122122212222222221121211222121222221122122122112112222222221122222222222221222112222222221122222222222211222222221212222222222121
122221212122122222222112211212222222221221211212221113121221212112212212222222221122222222222221212212222222221122222222222211222222221212222222222121
121112212212122222222121222112222222221211212212112221221211212221211212222222221122222222222221211212222222221122222222222211222222221212222222222121
122212122212122222222122112112222222221222212122122122122211222121221212222222221122222222222221221211111111111122222222222211222222221212222222222121
111221121212111111111112112111111111111221112211221212111112211322122212222222221122222222222221121222221222222122222222222211222222221212222222222121
121121122122112221221122212212222221222212221221212122112212122121111212222222221111111111111111122122111212211111111111111111222222221212222222222121
122121212121222122112221221222111122211122122122222121222112121122221212222222221122221222221222212112222221222212222222112221222222221212222222222121
122222212121211212112111122111111111112221212211111121211122221221111212222222221221122211211211222111111112111211221211222121222222221212222222222121
121211112121211212222122212122222222211211211212222221222221112211122212222222221212211111212221111122212222112211211221212121222222221212222222222121
112212222122211221111221212122222222212211211222111111111111122112221112222222221221222221222122122221122122222121222112212121222222221211111111111121
112112112211122212221112212122222222212113222112122222222222121122112212222222221122111121111222121111221213111221212222221221222222221222111222222121
112212211111312222122222122122222222212221212112122222222222122221212112222222221212122221222112221222211221222212211111112221222222221212221211211221
121221222222222111111122121122222222211121212222122222222222122111222212222222221212221112212211121211122121212122121112222121111111111211121211222211
121122111111211222222111121122222222212221212111122222222222121222221211111111111211211222121211221211212221212221212222111222222122221221122211111121
122222222221222211112222221122222222212112122122122222222222121212111222221222221212211211122222111212211121221112212111111111112212212221211122212121
121111111111111111111111111122222222212212221212122222222222121112211121122121121222112212222112222212122221122112112122222222121211221122222121212221
121222222222222112222222221122222222212221122122122222222222122221222121222221122111222121111111111122221213112212122122222222122222121211112221221121
121222222222222112222222221122222222212122212121122222222222111122112121213112222222211211222222221121112222221222121122222222122112222222221111121121
121222222222222112222222221122222222212111212221111111111111122212221221111111111111111221222222221122221112112212121122222222121221111111111222221221
121222222222222112222222221122222222212121212111111111111222122111121212122222222222221121222222221221121222212121121122222222121121222222221211112221
121222222222222112222222221111111111112221212122222222221212212221121222122222222222221121222222221212122111122122122122222222122121222222221212222121
121222222222222112222222221112222221221111212122222222221211122121121221122222222222221121222222221212112212221112212122222222112221222222221212111121
121222222222222112222222221222121121121222212122222222221211221121121121122222222222221121222222221212221212112221212122222222112111222222221212222211
121222222222222112222222221211221122222211122122222222221221212223121221122222222222221121222222221212211222122121212122222222112211222222221211111221
121111111111111111111111111112212211111112121122222222221122212121221212122222222222221221222222221211222111221121212122222222121211222222221211222121
122211211111111111111122211222111222222222121122222222221322122121212222122222222222221211111111111222212222212222212111111111122211222222221211212221
121122212222222222222121222211222111211211221122222222221121221121221212122222222222221222222222222112111111111111212211112221121221222222221222211221
121121112222222222222122111221212222122222222122222222221221211221122212122222222222221211111111121222122222222221122122212121121121111111111111122121
122122212222222222222112222122221112211111312111111111111112211222111112122222222222221221122221122211122222222221221221222121122112222222221112221121
112111212222222222222121111111111111222222112212222221222222112211222221122222222222221122211121111111122222222221212211111221111222121122112222121221
112122212222222222222121222222222221221112211122122112212111212121211122122222222222221211221122222222122222222221222112222212221211222212222111122211
112121212222222222222121222222222221112221222122212122112112212121212212111111111111111212122112212112122222222221111122111112121221111111111111111121
112121212222222222222121222222222221222121112211212222212122112221211212222122212221222222112221122112122222222221222121122212122122122222222222221221
112122112222222222222121222222222221211122221211111111112121122111212211221221222122212211221122221122122222222221112122221222112112122222222222221211
112112212222222222222121222222222221212221121212222222212121221222212122122211111111111222111111111121122222222221222311112111112212122222222222221211
112111212222222222222121222222222221221111222212222222212122212211122222211121222222221212122222222121122222222221212122112222211212122222222222221221
112221212222222222222121222222222221122212211212222222212122122122121111122221222222221212122222222122111111111111212212122211221212122222222222221121
121121212222222222222121222222222221121212122112222222212121221121222221121211222222221212122222222112112222212222211212221222121212122222222222221121
112221212222222222222121222222222221121212212112222222212121212221211122221211222222221212122222222112212121211122112212222112121212122222222222221221
112112211111111111111121111111111111221221212212222222212121221122222111211211222222221112122222222121211221222212212221111222312212122222222222221211
112112122222212222211111111111222212212121221212222222212211122111111222122211222222221222122222222121221212111221212112222122122112122222222222221221
112122211121221221212222222221212122122122122212222222211222222222222212221121222222221212122222222122122211222122212222112221121222122222222222221121
112221222221122212212222222221212121222112111112222222211111111111111111111111222222221212122222222121111112212211111112122112221211111111111111111221
121111111111111112112222222221212222212212222211111111111222222222112222222211222222221221122222222121222212111222221112211112112212222211222221222211
122122222222222212212222222221111111111111211212112222221222222222112222222211222222221222122222222121211212221111121222212222132221111212211221211221
112122222222222211212222222221122222222212212212221121121222222222112222222211222222221212111111111121211222122211112211122121212112221212221211221121
112122222222222212212222222221122222222211122111121121121222222222112222222211111111111212212221312222212111211222222222121121212112122212121222122121
122122222222222212112222222221122222222212221122221121221222222222112222222212122211222212212122221121122221111111111111122212222112111112212121112121
121122222222222212212222222221122222222212112221112221211222222222112222222212221222211122212211222221221121222222222222111222111212222211212121222121
122122222222222211212222222221122222222212111122112112211222222222112222222212212111221221211221211112211111222222222222121111222222211222222122212121
112122222222222212212222222221122222222212122212222312121222222222112222222212221222112211222122122212122221222222222222122222111111111111111221112121
122122222222222212112222222221122222222212121221112112211222222222112222222212111212122111112112211222221121222222222222112212112222222222221212221121
121122222222222212112222222221122222222212221122212221221111111111112222222212122212221222222221222122111221222222222222122112212222222222221212121121
122122222222222212212222222221122222222211111111211121122222222222212222222212121111111111213111112211112221222222222222121221212222222222221212112221
112122222222222211211111111111111111111111222222212222211111121111212222222211121222222221221222222222222121222222222222121122212222222222221222112121
112111111111111111211222222222212222221222211121111111111111121122211111111112221222222221112211111111111111222222222222122122112222222222221211112121
112212222211222111221211122111211121121112121121222222222222121121221122222112121222222221122121222222222211222222222222122211212222222222221212222121
121212121122212221121211212111222221122222122211222222222222122212222221112222121222222221121121222222222211222222222222121222112222222222221112111221
112212122121111122221222212222111111111111111221222222222222111211111111111111121222222221122221222222222211222222222222121112112222222222221222112211
112122112221122111111111111112122222222222221121222222222222112212222222222221221222222221211121222222222211111111111111122122111111111111111211222121
122121211111121122222222122212122222222222221121222222222222122212222222222221211222222221122121222222222212211222222222222121221122222212222211211121
121221222222122122222222121222122222222222221121222222222222121212222222222221221222222221221221222222222211222211111111111222122121111222112121212221
121211121212112122222222121212122222222222221221222222222222121212222222222221121222222221212211222222222213221112222222221212212221222121222121221221
121222121212122122222222121212122222222222221211222222222222121212222222222221221111111111212121222222222211212212222222221211212211212121211122122221
122112121212222122222222121122122222222222221221222222222222122112222222222221211111222221222221222222222212212112222222221212221112212112211112111121
121112121211112122222222121121122222222222221121222222222222112112222222222221222222112122213111111111111112112212222222221221122222122222112222221221
122222121212112122222222122212122222222222221221222222222222112112222222222221111112112111111111111111122112121212222222221122112211111111112122112211
121111221212222122222222111222122222222222221211111111111111112212222222222221222212212221222222222222112122121212222222221212211212222222211121222121
121221112212211122222222122211111111111111111222211222111222221211111111111111211222221121222222222222112221222212222222221221212212222222212221211121
122121222112122122222222121122221222222222221221222212222212212222212221111111111111112221222222222222122111211212222222221121212112222222212111212221
112221211212112111111111122221222111211221121211111111111111222111221121222222222222212111222222222222121112222112222222221121211212222222212221212121
121121221222212222121122222112212221211211112212222222222221211222121221222222222222212221222222222222122212112111111111111221222112222222212122212121
122122121111212112122211111111112121221222212112222222222221212212122221222222222222211121222222222222111212212222221112222212112212222222212211111221
122212221122212112111212222222212121122111212212222222222221222122112121222222222222212221222222222222121211111122122212111222121212222222211212221211
121211111121112122122212222222211221222212211212222222222221211121222121222222222222212111222222222222121222221221211211122212221212222222211222122231
121222222122122121221112222222212212212122122212222222222221221221111221222222222222212121222222222222121112122211222222221111221212222222212111111211
121111112112121221211112222222212111112121121112222222222221111212222111222222222222212221222222222222121122111111111121112221111211111111112222221211
122211212112221212222212222222212222112122221212222222222221222212112211222222222222211221222222222222122221122222222121222121122212211111111111121211
111222212221111211111212222222212112212211111212222222222221211122121221222222222222212221222222222222122112122222222111211122221222112222222222122211
121212211122122212221212222222212121211222112212222222222221212221223121222222222222212121111111111111122222122222222122211111111111112222222222121121
122211122212121122121212222222212221212112222112222222222221222112221121111111111111111221122221222222211122122222222121112222222222112222222222121121
122112221212121221221212222222212111212221112112222222222221111122122121222222212222211211121121111121222112122222222121112222222222112222222222122211
111122112222122212222211111111112122212122112212222222222221122221212122211211222111221222221222222221112122122222222122212222222222112222222222121211
122221111111111111111221122222112121112112221211111111111111221111212111121211111111111111111111111111212121122222222121212222222222112222222222121221
121223122222222222212121221112221121122221121212221222221222212212222122221212222222211222222222222212212121122222222112212222222222112222222222112121
122121122222222222212122212221122221221111111221122212121221112112111221221212222222211222222222222212112122122222222112112222222222112222222222122121
112122122222222222212211112122211112212222222121111112121121122212112212112212222222211222222222222212212212111111111112212222222222111111111111121121
112112122222222222212122212212111222112111122121222222122221221222222112112112222222211222222222222212221212112221222121212222222222112222221222222121
112212122222222222212221222212222212212121221122211111211211111111111222222112222222211222222222222212121212222121212221212222222222112112112211112121
121211122222222222212211111111111121222221211111111222122212222222221211111212222222211222222222222212121211111111211222212222222222122112222222212221
122222122222222222212111222222222121111221222222222212221112222222221212222112222222211222222222222212121222222221221111111111111111121211111111111111
111212122222222222212221222222222121221111111111111111112212222222221212112212222222211222222222222211221111111122121222211113111221121212222222222211
112212111111111111112121222222222122221222222222222211221212222222221212121211111111111111111111111111211122222112121111222222222122122212222222222211
112112222111222112212211222222222121121222222222222211212212222222221222121222222122221212222221222221222121212212221222111112112112112212222222222211
112221121222212222211211222222222121111222222222222212222212222222221211222111212221122122121121212211212221211211112212112222122132221212222222222211
121111221211111121212211222222222122221222222222222212111212222222221222212211212111112121122121211222211111221212221212112121222212121212222222222211
121222211212221121122121222222222111121222222222222212221212222222221121111122211222212121212212211111122222122122122212222122111222111212222222222211
122211211222122122221221222222222122221222222222222212121212222222221212222121112211221121211222122211221112212122212211112111222121122212222222222211
121111222111112211112211222222222121111222222222222212122112222222221122112221222122122221222111221222212222222121122122212122212121221112222222222211
122221112211221212222211111111111122221222222222222212112112222222221121122112211222211112122311212122111111312121121221211221112211212212222222222211
122121111122212211111222222122222211121222222222222212122112222222221122122212112211222112222122212222122222122121122211221212221211211212222222222211
121121222221222222111221112111121212221111111111111111222211111111111112211112212121112211212121111111121112211222211122121212121221212211111111111111
122122211112113112222212222222221222122222222222222222211222222222222221222222222122222222212122222222222221222211222221122222122122222122222222222221
111111111111111111111111111111111111111111111111111111111111111111111111111111111111111111111111111111111111111111111111111111111111111111111111111111
