111111111111111111111111111111
122222222222222222224222212221
122124214111111111122122122121
112121222222225212212422221221
122121222222222212122121124211
121121222222222212221441221211
124221222222222222112221212211
121211222222222212222122112121
121224222222222211144112222221
122124222222222222222221124111
122211222222222212111121112224
121211222222222242222122222121
124221411211111112411111411124
121122222222222222122222222221
122111111441111112422222222121
112222122222222112122222222121
121112122222222122122222222121
122212122222222224122222222421
121142122222222122122225222121
122222122222222112122522222121
124111422222222142122252222121
122111122222222112422222222121
112122122222222412122222222221
112142122222222122122222252121
122122122222222124122222222121
124121111141112122441214111121
121122242222222211222222212224
122211221141121222114221221121
111222122222221112222212222221
111111111111111111111111111111
