111111111111111111111111111111111111111111111111111111111111111111111111111111111111111111111111111111111111111111111111111111111111111111111111111111
112222212222221222212222112211112222212222222222222222222211112222222212222222212212221222212221222222111111111111222222222222222222222222112222222121
122121212121122121221112221212222122122122121111111121111122222121111221111121221212122211222122211212222222222221211221121111111111111112112122112221
121221212122112122122221122222111221121212121222222222221221111112221122222221122212111111111111122211112222222221211121122222222222122222112112211121
111211112212212212111121111111112212222212122222222222221211112222122211111111111212122222222222121222212222222221122221122222222222121111122121222121
122212221211211222122222222222212122111122121222222222221222222111121122222222222212122222222222121111212222222221121112122222222222122112221221112111
121212122211221111111111121111212221222221221222222222221211111222122211112111111122222222222222121222212222222221221112122222222222112212121211212221
121112111112121222222222221122211121211112211222222222222211112112111221122112221121122222222222112212212222222221212222122222222222121211221222211121
121222112222121222222222221221122212212222111222222222221222221222221122211112121122122222222222112122212222222222222112122222222222122211212221222121
122211312122121222222222222222221222122112221222222222221111121212212211211222122212122222222222112211212222222221211122122222222222121122211121212121
121122222312121222222222221211111111111121121222222222221211221211222221222211212112122222222222121222112222222221212221122222222222222211222221221221
122121212111221222222222221212222222222121221222222222221221212222111211211111112222122222222222112112112222222221212111122222222222111222111111121211
112121212221211222222222221212222222222121211222222222221121212112122222222222211111111111111211122112212111111111212222122222222222121112212222211211
122121211121211222222222221212222222222121211222222222221121212122121112222222211222222212222222221111222221111111111112122222222222122221222111221221
121111221111211222222222221222222222222121221222222222221221211221121212222222212212211222111121112222112121222222222212222222222222122121111222122121
122222121222211222222222221212222222222122121222222222221212211211221212222222212112112211111221222112212111222222222212122222222222121122222212222221
111112221211221111111111111212222222222112121111111111211222112211212212222222212122122122222112211211212221222222222212121111111111111111211111111121
122212121212122222212111222212222222222112222112222222222222222121211212222222212121221221112222122222211121222222222212222221122222112222222222212121
121212112212111121221222111112222222222122131222111211111111111112211212222222212121212211112111111121122221222222222211111212221112212222222222212121
121212212112211221112212222212222222222121112211122222222222122212122222222222211221112112222222222121221121222222222212222222112211212222222222212121
122122212211222211112121111212222222222121222122122222222222121212122112222222211212222112222222222221212121222222222212111111222122212222222222222221
122211221222122112222221122211111111112121211221122222222222121212112212222222212212112212222222222122212121222222222212122222212221112222222222222111
121222122112211222111112221222222211122212211211122222222222111212211211111111112112122212222222222111122121222222222212211111121111112222222222222221
121112212121211211222112111111121122221222122222122222222222222211211222222222122212211212222222222112221221222222222212222222212222212222222222211121
121221212121221211212122122222221121113111121312122222222222121221212211111112113221221212222222222112122211222222222212111111222121212222222222211121
121211222222122222211121111112111221222222122112222222222222121121212111222122221212122112222222222112111121222222222212211222121121212222222222212221
121221111111111121112221222222221211212112111222122222222222121312222122212212122212112112222222222112211121222222222211211212122211211111111111112111
121121222222222221222121222222221222112122211212222222222222122222111121121212111122212111111111111122222221211121111112212212111211222222212222212221
121121222222222222211221222222221112212211221212111111111111121211112221322212212221222122222211122211111122221222212222112122112222111211212111121121
122221222222222221221111222222222211221221122212111111111111111212222111121111112112111121221222211222221311121121122111222121212111222112212222211121
111121222222222221122221222222221221121121211122112222222222221212121222222222222122212121122111222111122222121121121221211122122122212222122211222221
121221222222222221121121222222221121122121222121212222222222221212122111111111111121222122212212112211111221122121122212211312211221111111111111121121
122211222222222221322121222222221222112221212122112222222222222212112122222222211221111121121212122222211122212122112212122221222212122222222222221121
121121222222222221121221222222221212221112212112112222222222221212122122222222212212221121221212221111222221122112222212121212111112122222222222221121
121221222222222221221211111111111211112222112212212222222222221212121122222222222122122222221212111222111212221111111122121212112222122222222222221121
122221222222222221112221122221222211112121122211212222222222221122122122222222212121211111121221222212221212111222221121212212222112122222222222221121
111121222222222221222122121122211222222122121221212222222222221221222122222222212222212222212122211121122112122211122121222112121222122222222222221121
112221222222222221211112122211111111111112112221212222222222221212112122222222212111112111221111111111122222121212212221212212121212122222222222221221
112111222222222221222221211212222222222212112111212222222222221212212122222222212221222111121122222222121111212212131112211222122122122222222222221211
112221222222222221211121211212222222222212221222212222222222221211212122222222211112211222122122222222122122222112222122122111212111122222222222221221
121121111111111111222122222212222222222222121211112222222222222211222222222222211122112212112222222222112121121222121322212122212222222222222222221121
122122211222111111111111211112222222222222122222112222222222221222111122222222212221222112212122222222112212221211122121122211221212122222222222221121
112111221212212222222222222112222222222212111112212222222222221212221122222222212112221221212122222222121222111212212221121211212212122222222222221221
112222121211212222222222222112222222222211222221111111111111211221121122222222222212121212212122222222122111221212111111221213221122122222222222221211
122211121211212222222222222112222222222211211122222221221222222222122122222222211212212222112122222222112222211212222222221211222121122222222222221221
121212221221212222222222222112222222222211212211111122122211111111112111111111111221212111112222222222122121111211112211121212212121111111111211111121
122112111121212222222222222112222222222211221222222212211112222222212221111222211121212212222122222222221221122211111212212211122122221222222222121221
122212112221212222222222222112222222222211121122111221222112222222212212222211222222211212111111111111121112221112221212122122221122121211121112212211
121212112121112222222222222111111111121112221121111122112112222222212222111111111111111212212222222222222222111222122212222221111221221221122211212121
121212212122212222222222222121312221222122111222222211112112222222212111222222222222221211212111111111112111222212111211111111122212212122211222112121
111221221111212222222222222122222121212121111211111222222112222222212122212222222222221211211122222222212222121122122222222222121122112111211112212121
122221122222211111121111111111211121212122222111111112112212222222212221212222222222221221222122222222211112121121122222222222121222212221222211222121
121122111111222212221111222112212221122111112122222222211212222222211112212222222222221121112122222222211222122211122222222222121111221121122122111221
122211222222111222122222212222111122222211112122222222212212222222211222112222222222221212222122222222211211221222222222222222122221121222112222122121
122111211221222121121111111112122211112122212122222222222112222222211211222222222222221222111122222222211221222112122222222222111122122212111112212221
122222222122212222222222222211221212222121222122222222212212222222222212212222222222221122122122222222212121111222122222222222122212211111222221221121
121111111111111111222222222212211221211221112222222222211212222222212112112222222222221121112122222222212122222212122222222222221211222222211121122121
121222222222222211222222222212121121211212212122222222211212222222212122112222222222221121222222222222212211111112122222222222112231111111111122212121
121222222222222211222222222212122121122212122122222222211212222222212221111111111111111121211122111111111222212222122222222222122211222222222112212221
122222222222222211222222222212112223121122121122222222211211111111111211222111222221131121222222222111112212122111122222222222121221222222222112121121
121222222222222211222222222212212122221212121122222222211211221311222221212222111122222221211112112222222122121122122222222222121121222222222122221121
121222222222222211222222222211211222111222221111112111111222122222112112211112222122121111222212221111112111122212122222222222122111222222222221211221
121222222222222211222222222213222112211111111111222222111112111212122112122221112121221222111122121222222222111222122222222222112221222222222122122211
121222222222222211222222222211212211112222222221122112122212122212121122121121312211213221311221221222222222122122112111111111111121222222222112121121
121222222222222211122111111111221222212222222221221222221122121112211121122122221221211222222211211222222222112112112221112222222221222222222112122121
121222222222222211222111111111111111212222222221212211221221221111222122212211222222212211211122221222222222112222122122222121111121222222222112212221
121111111111111112212112222222222211222222222221221112212211212222112111221131211111111111212221121222222222122111221211122312222121222222222121222121
121221222211222112122112222222222211212222222221222212112121222112112222122222112222222221211112221222222222121221211212222122112211222222222121111211
121122211222212221121212222222222212212222222221211221112122211112121112122122212222222221222212122222222222122122222212111121221221222222222221122221
122212221121121122221212222222222212112222222221212121222121122212122112111221212222222221221221221222222222112212111211222121122121222222222122121121
111212112221221111122212222222222212212222222221212122211122121222112222222111212222222222211121211222222222121212221222212222212121111111111112221221
121212212111212222211212222222222211212222222221222111131111121111112111112122212222222221212221211222222222122211111111112111222122222222122212212211
122211122122212111222212222222222211222222222221122221222222223122222222212221212222222221212112211222222222221112222222222221122111221111121222112111
122122221121222221111112222222222212211111111121213121121111121122222222211112212222222221212112221222222222121222222222222221112221122222222111222221
121212112221113122222211111212111212122222221222231221221212221122222222222122112222222221212221121222222222121212222222222221221121211121111111111121
121222211111111111121122222212222222121221121112212211212212112222222222212122211121111111211122121111111112122212222222222221211221212222222222222121
122121222222222222222121211222122111212212122222112112212112112122222222212121212222222121122212121111111112111212222222222221212211212222222222222121
112121212222222222222112212111212112222112222111222222212212122122222222212122112111112122221222122222222211221212222222222221212122212222222222222121
112112212222222222222112112122212112112221211222213111221222121122222222212122122112212111122112122222222211212212222222222222212211212222222222222121
112212112222222222222122122221122122121121221211111111111121121122222222212221221222122111112122122222222211212112222222222221211211212222222222222121
121212112222222222222121121221221221121122111211122222222222221122222222212111211212121222222121122222222211212112222222222221221222212222222222222121
121212112222222222222121121112211212222112221222122222222111112111111121112112212212121221111221122222222211212212222222222221122111222222222222222221
121212112222222222222122122122112221212111122112122222222122221221222222121222112122121121222222122222222211221212222222222221122122212222222222222121
121222312222222222222112212121112121221222112222122222222121121122212212221211222211122122111112122222222222212211111111111111121121112222222222222121
122112112222222222222221212122221223122212221111122222222121122121122122222212211222212112122221122222222212122112222122221222122222212222222222222121
121222112222222222222221222211122121111221221222122222222121112122121211111111111121212212121121111112111112121222112121122212222131212222222222222121
122212212222222222222122213122212122211112221112222222222122212112121212222222222121211212221122222222222222122122211121111111211111111111121111111121
121122211111111111111122221221222121222112122222122222222121212121221212222222222121222212211211111111112122112121222122122222222222222222222222221121
111121111111112211111112111212111221112222112112111111111111212212211212222222222122111122112212222222222121112121112212122222222221211111211111122221
112222222222211212222222221211111111111111212211222211222222211222122212222222222112212221222112222222222122222122221222122222222221212222222222111121
112222222222211212222222221212222222222212211212211222111211112111221212222222222121212122212112222222222121111111211111122222222221212222222222112121
112222222222212212222222222222222222222212112212122112112212222222212212222222222121221211112222222222222121222222222221122222222221212222222222122121
112222222222212112222222221212222222222212222122121122112122111112111112222222222121122122221212222222222121222222222221122222222221212222222222121221
112222222222222212222222221212222222222211111221222221222121122222222112222222222121212112211222222222222122222222222221122222222221212222222222122211
112222222222211212222222221212222222222212221112122112212122122222222112222222222122212212112212222222222221222222222221122222222222212222222222121121
112222222222211212222222221212222222222212122112222212112212122222222112222222222121121212222112222222222122222222222221111111111112212222222222221121
112222222222212212222222221212222222222212212222211122221212122222222112222222222122122212211212222222222121222222222221222122221222222222222222122121
111111111111212111111211111212222222222211221111122213112212122222222112222222222112122112122212222222222121222222222221212221121122112222222222112221
122212122211222112222222222211111111111112122222221221112122122222222111111121111112121122112212222222222121222222222221221111122121112222222222121221
121222121221212212111111111221222122222222111111112122212121122222222121222222221122121222222112222222222121111111111111121122212122212222222222122121
121211121121211212122112222121212121111221222112122211222122122222222121211112121221221111112112222222222122112221122222122121212121212222222222122221
121122221122221222112222121221212221122211212222121222111212111211111121212222122212211222122111111111111112221122121212212122122121211112111111121111
122121111111121111111211221212211112121122221221121112222222221222222122212121111112122212111122221222122211122212221221212112122212212222111222221111
122221122222222222221211211222222222122221121121121211111221111211211221112212222112221122122221122112221222211212111121212112221122112112222112112221
121112122222222222221212222111211111111111121221221222212212222211211222221222112111112121221112112211212122122221222221212132212221122121112112212121
121122122222222222221122111222112222222222122111212112112112111121222211111111112122112121211112221211222112221122211111212112122112121122212222222121
121121122222222222221221112212222222222222112111221112112222222221111112222222212221222122212221221212111111211111111122222112221222222221111112111121
121121122222222222221212222111212222222222112222121222111111112112222212222222212122212211122122221212112222222222222121111111111111111121222222221221
121122122222222222221222111222212222222222111112221211222222222212122112222222212121111111112111121222222222222222222112222212222222222121222222221211
122112122222222222221211112211212222222222122211113221212222222212212112222222212122222222212222111111212222222222222122111212222222222122222222221221
112212122222222222221212222112212222222222121222211222212222222211112212222222212122222222212212222222212222222222222221111212222222222121222222221121
121212122222222222221212111222112222222222121121221211212222222212221212222222222122222222212111111111112222222222222221222212222222222121222222221121
122212122222222222221212111211212222222222121121122111212222222222122212222222212122222222222122222222112222222222222121212112222222222221222222221221
121112111211111111111112122211212222222222121122212222222222222212112212222222212122222222212122222222112222222222222122112112222222222121222222221211
121222122211131122222222121122211111111111122211221112212222222212221212222222212122222222212122222222112222222222222122212212222222222121222222221211
122212211222222211112111122122112222211122221122121221212222222212122112222222212122222222212122222222112222222222222121221212222222222121222222221211
111111221111121222222122212122222111222211122121121121212222222212122212222222212122222222212222222222112222222222222121121212222222222221111111111221
121222121122221111111121212121211221111221212221122122212222222212121212222222212122222222212122222222112222222222222122121212222222222121222222222121
121212221121111222212222112112212212222121211221212121111111111112211212222222212111211121112122222222112222222222222112121112111111111112211111112121
121211112221122211222112222222112112112221221121212212222221222221122211111111112112222222212122222222111111111111111122122222222222222212222222122121
121222112122211212111111211111112112121112122222221222122122212112221222221222222212112111212111111111122212221221112121111111211111221212111112121121
121112212211221222122222222222122112122221111111111111121111112212111112122122111212112212212211112222221212122212222121222222222221211221222221121221
121111221221121122122222222222121222121222222222222221221221222222122222112121111122121221111222221112212212212212121221222222222221222122211121121211
121222122122122211122222222222122211221211222222222221212211211111111211222122222221322122221111122222132221211212121211222222222221112211112222221221
122212212111111222122222222222122111212211222222222221221212212222222211211121111111122211122222111111112112212212121211222222222221121221222121122121
121121212112221212122222222222121122212121222222222221121212112222222212211222222222121222212112212222212212122122121221222222222221221121111221222121
121121212222121212122222222222121221212221222222222221221222212222222212121222222222121221212211122121221212122221221121222222222221211221222112211221
112222231111122112122222222222121211212211222222222221212111212222222222121222222222111211221222221122121212111111112221222222222221221211212221121211
112111211222212212122222222222121222121221222222222221221222112222222212221222222222122211112111112212212212122212222111222222222221121222211122112211
112221222211111222111111111111121112221121222222222221222212212222222211122222222222121122221222222121222112221222111221111111121111122111111212112121
122122111122222111212222222122122121112221222222222221211111212222222211221222222222122221122211112111211111111112211212222111222222212221222212122121
121212221121112221212121112221222212222121222222222221212122212222222211211222222222121111111111112212222222222211211222112222211211222122211122121221
122211121221211122212121111111111212111222222222222221222121112222222212211222222222121122222222211212222222222211221222121112111221111111111121121121
112222122211222211212121222222221212221211222222222221112122212222222222111222222222121122222222212212222222222212122112122212221121222222222121122121
121112211121112231222121222222221212121221222222222221222211212222222212221222222222122122222222212112222222222212112112111211122211222222222222212221
122221212212222212111221222222221212121121111211111111112221211111111111121111111111112122222222212112222222222212222112212222211211222222222111211121
122112212122121221122211222222221211221221122222221222212112221111111111111111112222212122222222212212222222222212111211212121111211222222222111222221
112112132221121212221211222222221222211212221112122211211222122121111111111221222121122222222222211212222222222212221222212112221221222222222122111111
122122112112221212111211222222221211111211111112111122211211112121222222221221211221121122222222211212222222222211122111222122122121222222222121311111
121221122122112212112211222222221212221222122222112221131211222121222222221221212211122122222222211222222222222212112112211221212221222222222122222221
122212221121122122122121222222221122121112221111122112222211211121222222221221211122212122222222212212222222222212212221122211211121222222222121221121
122122112221221121121121222222221121122221111221221222121121212121222222221221222221212122222222212111111111121111221122221121222221222222222121122121
121221212111212223121121111111211221111122212211222111121221212221222222221221211111222122222222212222122221122222221211111122211111222222222122212211
121222212122221221121221112122212212211221222112211222221211212121222222221221212221111111121211112212221212221121122122222211221221222222222111221211
122111112212112212222212222121222111221212211122122221111211212121222222221221222121122221222221221211111212112121112121111221121211222222222111121211
112222121212122122121222121221111222121221111121121121222221222121222222221221111122221121122121212212222112112122221221222122122211222222222122211211
121112221212121111221111221212221212122122122221121212211122112121211111121221122211111221221121212112112212222211122212212112112231111112111121211221
122221221212122222112221112212122212121212221211121212122212112122222222222221221212221212211122212112121221111211111112122112211212222112221221222121
122122222212211112222122222222111122222211111222221222221212222111111111111111211222122222122222212222221122222222222222122221222222112222122212112221
111111111111111111111111111111111111111111111111111111111111111111111111111111111111111111111111111111111111111111111111111111111111111111111111111111
