111111111111111111111111111111
112222222222222222222222422221
112411111141111112121412121124
112122222222222211221122142224
122122222222222212212222222121
121122222222222212441121144121
121122222222222512122222222121
121422222222222212122222222221
122122222222222212122222222121
112222222222222242122222222221
112122222222222222122222222121
122122222222222212422222222121
124111114111111112122222222221
122221222222221122122222222121
121141211114122212122222222121
122122211222211222422222222421
112121122221222412111411111421
122421221121111411111141222121
111224221221222222222222244121
122212121211222222222222222121
121124222121222222222221212221
121422212224222222222221221421
122111142111222222222221122121
122222212214222222222224412211
121111244211222222222221221214
112222211211222222225224211214
124221112221222222222224242211
121242222124441414111114212121
122212111122222222222222222221
111111111111111111111111111111
