111111111111111111111111111111111111111111111111111111111111111111111111111111111111111111111111111111111111111111111111111111111111111111111111111111
122222221221111222222112221222222211222222222222222111222211222122112222222111111111112222222222222221122212222121222212222122212222212222221222112221
121112121212222211212221221211211222112111111111111222211222212112112112212122222222212111111121111121221211212212212112112121222112212112211212222121
121122122212111112211121211221221112112122222222221211122211112222112121221122222222212221222122221222212222211212112112212121111222122211211211111221
121221112212212222122222222122121222222122222222221221111122211111212221122122222222211122212111121111111111111221222111212222222122121122211222122221
112212221221212111121111111112122111111122222222221222222121222211211221212122222222212211112222121222222222221121212221212211111222122121122211121121
122122121121212122121122222222112222222122222222221211112221111222221121212122222222212122221211221222222222221122122122212112222212112121121112221121
121221122212212121221221111111111111112122222222221211111111111111122221212122222222212221222212211222222222222212121111122122121111222122122122111221
122222211222112122211211222222222222212122222222221212222222222222121111212122222222212112211212121222222222222212111222211221221222211212222121222111
122111111111122122122211222222222222212122222222221212222222222222121222212122222222212221111212121222222222221212221211211211111211111111112122212221
121122222222121221121121222222222222212122222222221212222222222222122111212122222222211121222122121222222222221211121221213222222212222222212211111121
121122222222222111221122222222222222212122222222221212222222222222112112212122222222222221212221221222222222221222122121221211211112222222211212222221
122122222222112221211221222222222222212111211111111212222222222222122122212222222222212111211112221222222222221212112122122111221212222222212212111121
112122222222111121222211222222222222222222222222211212222222222222221221212111111111211111222122121222222222221112112212112222121222222222211112212221
112122222222122221111211222222222222212211112211212212222222222222121211212211222112222222112122111222222222221222221212111112122212222222212221212111
112222222222121222111211222222222222212122222112212112222222222222122212211222212222111112212212221111111211111211121222122122111212222222212121212211
112122222222121112122211222222222222211121111222122112222222222222111112121112111111111111211212121222222211222222212111221121221212222222212122211221
122222222222122111221121222222222222212221221211222212222222222222122212122112221222222221222211222111221211211111221312211122121212222222212211121121
121122222222112222222221111111111111112112211211111212222222222222221122112111121222222221111122212221121212211222122222122212121212222222211211112221
121122222222121121111111122112222222122312122212221112222222222222122222222122221222222221222221111121121221122212211211221212121212222222211222212111
121122222222121222222222121222112112112112121122122211111111211111122111112121121222222221212212221122221122221111211212211222122211111111113221212211
122111111211121222222222122211122112222112121221211221122212222112221222122122121222222221221212122211112211112122212212111211111112211122221212211221
112221122222221222222222121122221221111112122212212122212222121222111212121112121222222221121221122122221222222121122122122222222212122221221212122121
111121221111221222222222122121112212222222211122212211212111122211122212211222121222222221111121121121122221211122222121122222222212221111212212212221
122121211222221222222222112122122122112121122221221222212222111122221122222211221222222221222221121222211121212221112122122222222212112221212121211111
121121212211121222222222122112121221222122211221212221111112221221121221111122211222222221211111222211212212212112221212122222222222112122212221222221
122122112121221222222222111112122211211211221121212111222221121211122112221221221222222221211222211121212222112122122122122222222212112212221222111121
112212212122211222222222122222122121211212222221212222211122112212222112121112121222222221212212112221212121222121212221122222222212111221111112122121
111211212211211222222222121111222221222221112111111111111112112122111222122212121222222221221112221121211221211121221111122222222212221122222222221221
122211221211221222222222122111111111111121122222222222221222112121222212211212221111111211122221122121222111212122122222222222222211121111221211111211
121121121211121222222222112122222222222121122222222222221211222212211122212211112222222222212211222222112222222112112112222222222212221222121222122211
122122221222211212111111122122222222222121122222222222221221211222221111112111111111112111221222112111111111111212122122111111111112112212122111221221
122222111211211222122221121122222222222122122222222222221121211111121222222122222222222122121212122222222222222212221121222222221111112122112122211121
121111222112212212211222222122222222222112122222222222221122122222212211112122222222212121221212122222222222221211111121222111122222222122221221112221
121222212112122111221211112122222222222122122222222222221212221111222122122122222222212121212212222222222222221222122221212111111111111111122221222111
121122112212121221121122222122222222222121122222222222221121111222111222221122222222212121211112122222222222221112121112122222222222222221111121211221
122221221212122121121221111122222222222121122222222222221221111212222211112122222222212221222112122222222222221222122132221122222222222221222212212121
111111121222112121121212221122222222222122111111111111111211222211121222222122222222211122112112122222222222221211212212122122222222222221212122112121
122222221112212122221212122122222222222112222211122221111222211122211121122122222222212221222112122222222222221211211212212122222222222221212221122221
121121222221212112212212112122222222222112111212221122222221222121222121112122222222212111211222122222222222221222212211122122222222222221211112221221
122122111111212212222121222122222222222112121212111111111111211221112212221122222222212111212212111111211111111211222112222122222222222221221222111121
112212122221221221111112212122222222222112121212222222222211221212221212121122222222212221212132222122222221112222111222112122222222222221122211222121
122212221121121121222212112112111111111122122211212222222212221212121222122122222222211121211112111221111122222112222211212122222222222221211112212121
121221111122221121211222212112222122222221222112212222222212112212122111212122222222212121222212212212222211111111111111222222222222222221222222122121
112121222212211221212111212222212221112111111222112222222211112111112222122111111111112121111221222122111222222222222122211122222222222221211211221221
122121211221111212212221221121211111222122222211212222222212222122211112121222211312222122122122111221121212222222222221112122222222222221221221111211
121221211122222212222122122122122222111221111112212222222212111221212222122121122222112222221212222222221222222222222121122111111111111111122122221221
122211222211111111111111222212121112211211222222212222222212222211222122112122221211111111211211111111221212222222222122121222211111111111111121121121
122122121212222222222221211212122121222212212111212222222211111122111212212221112212222222221222112221111212222222222112222211212222222222222112222121
121221221222222222222221211211222121111111112222112222222212111121221212112111111112222222221112212122222212222222222221111122212222222222222112112121
121211112212222222222221211222112122222222221122212222222212222221212222122222222112222222221111212211122112222222222122222121212222222222222132221221
122212222112222222222221221112222111111122122121212222222211221221222111122222222112222222221222221211112112222222222122211221212222222222222112212211
112212112112222222222221122221111122222221112121212222222211212122211112122222222112222222221212211212222211111111111121222222112222222222222111212111
121122122112222222222222212122211221111111222211211111111113222111112222222222222112222222221221211212111111111111111121111112112222222222222122212221
122221221212222222222221222211222212222222211222222212222221211222212122122222222112222222221121212212212222222222222112221222112222222222222121221121
112212211212222222222221121111112111111112111111111212111121221211122212122222222112222222221122122111212211111111111122122112212222222222222111212121
122122222212222222222221122222222221122222222211221212122222121221221212122222222112222222221112121122212212222222221121212211212222222222222122222121
121211111112222222222221122222222221122222222211212212121211221122212212122222222112222222221222122121212212222222221121221221212222222222222121121221
122122221111111111111111122222222221122222222211212122112212212122112122122222222112222222221212112212212212222222221121121121222222222222222122121211
112121122222222222222221122222222221122222222211222121212112112222212121122222222112222222221212121221112212222222221121122122111111111111111112211211
112121211111111122121121122222222221122222222212211121212212211121122121122222222111111111111212221222212212222222221121222212222222212222222211221221
132221221222222222121122222222222221122222222222222221222221222212221221111111111122111112222122112211212212222222221122111211111112122111111221122121
112111121222222222122211122222222221122222222212111111111211111222112212222211122212222222122221112111212212222222221112112222111112222111112122121221
122112221222222222111222122222222221122222222212211222222222222111112112111222111111111112121212221222212212222222221122112112222221112222222112122211
121222121222222222122112122222222221122222222211211222222222112222212222121212122222222212211212122211112212222222221121222111111111111111122212122211
121122121222222222121222111111111111111111211112211222222222112111211111221221122222222211211212211211112211111121111121211212222222222222111212211211
122121121222222222121212212222122222222212222122221222222222112222122222211121122222222212212231211122222222222222222221211212222222222222121221212211
112221121222222222121211212112221112112122122211111222222222122112221221122221122222222212122211222221211111111111112121222112222222222222122221212221
121111221222222222121212212221112222122121121212221222222222121221112122221112122222222222121222111111221222222222222221212212222222222222122112211111
122212211111211111121211111122221121111122211222121222222222122122222111111222222222222211221112222222122211121111111121211212222222222222121112112221
112212122222221222221222222111121121222111211111222222222222112212121131122212122222222211212111211111111111222222222121221222222222222222112222112121
112112112211121121113112112122121122212221212222211111111111111212122222212212122222222213222122222222222211222222222121121212222222222222122112212121
122122122122121122222212122222122211112121212121122222221222222212211121222122111111111211221122222222222211222222222121111212222222222222121122212121
121221221121121111222122121112111211212211212212221121121211211111111121111221122212112221122122222222222211222222222122222212222222222222122211122121
121212212221122222212121122211222222211222221222111322211212222222222121221212221221222121112122222222222211222222222111111111111111111111111222221121
121212212122222211112122211212211111111111121111222121122212222222222121212222112121211122222122222222222211222222222222212222212222211122111122112221
121211211111213122221121221212122122222222222221212223121112222222222121222311112221211221112122222222222211222222222121222111222121222212122212122121
122222212221221221122122122112212122222222222221221121121112222222222121112122211122212212221122222222222211222222222122111222111121111222221212121121
121112212121112211112212212221222122222222222221121121322222222222222122221221222112212112121122222222222211222222222112221212221221222111112212122211
112221122122222122221221212121112122222222222221121121121212222222222122122222112221211222122122222222222211111111111111122221121212212212122131112221
112121121111111111121121122122212122222222222221121122122112222222222121111111112121122211112122222222222211222222211222211111121122121212121222212121
112122122122222222122221121111212122222222222221122212212112222222222122122222222121121122212122222222222212212121212211222222122222212212221121212121
132212212122222222112212222221212122222222222221221221212112222222222112122222222121221121222111112121111111112122122122211112211131212122112221212121
112221222222222222132221111111212122222222222221222121212212222222222112122222222122211221112221122222212222222112121221122211222111112121112111221221
122122112122222222112112222221222122222222222221111221221211111111111112122222222222112212131121121221211221111222122111221212212122212122212122121211
121212221122222222112222111121211122222222222221222211111212211122122212122222222121222112222121221213222212212211212122211211112221212211222121221211
122211121122222222121111211221221122222222222221211122221212222221221212122222222112211122122221111221211121222111212221221222121111211212111122212221
112221122122222222222221222211122122222222222221222121122212121221213222122222222122122121121112222121212221111222211112222112122212211212122221121121
122122112122222222121122221122212111111111111111212122211111122122121211122222222121122222212222112221221222222211222221112212211222222212221121112221
121211222122222222122211111221221112222112222221112121122222112112112211122222222121221131222111221112121111111111111122211111211111111112111122222111
121221212122222222121122222212221222112112111122222121221112212112112122122222222121121111111111211122122122222222221211212222212222222222222111111221
121121212122222222122211111211121211222221222122112122212221212122112212122222222121122222222221222121112122222222221211222111112222222222222122222121
122121221111111111121222213222122212213122212121112211122122212121222222122222222121122222222221212221222122222222221222111111112222222222222121112221
112122122221222222222111221212112111111111112122211111112111222121112111111112111122122222222221221121211122222222221212221222212222222222222121111211
122122211121111111111122121122122222222222222121212222222221111122221222111222221112122222222221121221221122222222221211212211212222222222222121222211
121221222121122222222221122222122222222222222121212222222221222211121212222211122222122222222221121212223122222222221221222111212222222222222121211221
122112212122222222222121111112122222222222212121212222222221121222122211111122211111122222222221121221121122222222221122111222222222222222222121211121
112222112112122222222122211222122222222222212112212222222221121211111121222121222122122222222221221122221122222222221212121211222222222222222121212221
111111222122122222222121212211122222222222212112112222222221221122222322212222112212122222222221212211112122222222221212121221212222222222222121212111
122211211222122222222121212122122222222222212112212222222222211121122121111112221212222222222221222212222122222222221212222122112222222222222121212221
121212212212122222222121222222122222222222212221222222222222212221121221122122112212122222222221111212211111112111111211112212211111111111211121211121
121112122112122222222121112112122222222222212122212222222221222111122221121121212122122222222221221221222222222221222222221221211212222211222111212121
122222121122122222222121112111111111121111112111112222222221221222111122221221212222122222222221122121221111211121211312111121222122121222212221212121
111111221221111111111112221222222221122222121222112222222221211212222211112212221112222222222221122122112111211221211112222221112121122121121122212121
111111212111222212221112122211122112221212212212211111111111221221111222222122122222111111111111121212221222211211122221112222212222111221122211112121
122222231222211222122212111111221122111221212121211222122222122121111211111111221111222221222112222211121211111222121122221111221212122212221122222121
121111211211122111211222112221211221222121212121222212121221112121222222222221212222211122212212112221122212221112221211122222112221221112121221112121
121112221212212222211111122122212222112122122121111112222122222121222222222221211122122112121122221122212122122211112221211112212121212222122212222121
122212112212122212122221221221122111222112222222222211112111111121222222222221222121121222121221122211112121221122222122222121221221221221111211121221
121211222112221112121221211211121222211111111111111221222222222121222222222221212221122211222211211222221221211121121211312221121211121211222222221211
112211211222222212221211222112221211211222222222221121222222222121222222222221212111111112211112221111122211222221221111111111121112221211222222221221
122122211111111111111213112222111211211222222222221222222222222121222222222221222222222212112222122221112111111121211222222222122222111211222222221121
121221112222222222221222221111222212211222222222221211222222222121222222222221212222222212212121211121222222222121211222222222111111222211222222221221
122212212222222222221212112222212111121222222222221221222222222121222222222221212222222211211121221221222222222112211222222222122222211221222222221211
121121212222222222221212112111112222121222222222221121222222222121111111111111222222222211222122122211222222222112122222222222221112211121222222221211
122212212222222222222212222222221112221222222222221221222222222222221122212221212222222211112212112121222222222112211222222222111222122121222222221221
111212112222222222221221111112112221122222222222221211222222222121112221222121212222222222221212212121222222222221211222222222122211112221222222221121
121212112222222222221121122212222112221222222222221221222222222122112112111221212222222212121221212221222222222112221222222222121122212211222222221221
121212212222222222221121121221221222121222222222221121222222222112222112211212212222222212121121211221222222222112122222222222122221212121222222221211
121211212222222222221221121121112211221222222222221121211111111131111221212211111111111112122121212121222222222112121222222222121112212121111111111221
121211212222222222221212221222222122211111111111111121211221222222221121212112221122222122112122212121222222222122121111111111121122112222122211221121
121222212222222222221212111121211111111222211221112221222121211121122221212212121221112222112211112221222222222121221222213122212221211112211222112221
122111211111112111111212211222222222211211222212222112112222222122111122231212122212221112221221222111222222222121212211222221222113222221221112112111
122221212122222212122211222222222222211222121122111111111111112212122211211222111112111111111121211221222222222121222111112212111222222122122112112121
121121221221211212221111121222222222212112122222221222222222211112211221211111122212122222222121212121111111111122112222221221222112112112112112112221
111222122112211221111222221222222222211111111111121222222222212221221122222222221222122222222121212221111111111112111111122121212212212112212112121221
122212212112122222222211121222222222211222222222222222222222212122122111111111111112122222222122212121222222222222211112222121211211212221122222221121
121122212222121111111111111222222222211222222222121222222222222112212112222222222212122222222111122121222222222222222221121221221222211122221113111221
122121211111121122222222211222222222211222222222121222222222212211212112222222222212122222222112221121222222222222212122221211121111112211211111111211
112112221221122122222222211222222222211222222222121222222222212221222112222222222212222222222122112221222222222222212111112212222211122212222222211221
112221122212212122222222211222222222211222222222121222222222212121111212222222222212122222222121222121222222222222211222122122111122221212222222212121
122121222222122122222222211222222222211222222222221222222222211221222212222222222212122222222112211111222222222222212212221222222221111222222222212121
121121113112121122222222211222222222211222222222121121111111112212212112222222222212122222222122112221222222222222212111111111112121112212222222212221
121221222221121122222222211111111111211222222222122122122212222122112112222222222212122222222121222121222222222222212222122222222221222112222222212111
121212212212221122222222212211121222221222222222112121121222121221212222222222222212122222222122211121222222222222211112122222222221211212222222212121
121222221212112222222222212222221212211222222222122122221121221212211211111112121112122222222121122221211111111111111122122222222221211222222222212121
122113121222222211111111112121111211211222222222121221111221212222122222211222222122122222222121221121222111211112212222122222222221211212222222212121
121111111121211222111111111122221211221222222222222112221212212111221121122212111121111112111112212221212222122222212112222222222221222212222222212121
122222222222221212122222222121122222122222222222112222121122112211212122121112112221111112222222112111121212121121212112122222222221211111111211112221
121222222222221122122222222222111312121111111111111111121121221122212212121112212111222212112111212222212212122122112221122222222222212222211222221121
121222222222221121122222222112122111122221222221122222122121222221122222122221212222211212122122221111212122112112221122122222222221122121221211121121
121222222222221122122222222122121222221112211122121112212221212212221111212112211111122211221111122221212111222312222112122222222221221122112212121221
121222222222221212122222222121121212212222121112121221221112122111122211222122122222121122212222211121212222112112112212122222222221212212222122121211
121222222222221122122222222122121221212111122212221212121222221222121122221121121221221221111221222221211122222212122212111111111111221221111222121221
121222222222221222222222222112122122112122211221112222122211212212121221312121121121212212222211111221222121111212111112222222222211122122222212121121
121222222222221212122222222112121112212211222222112122111122212112121212222121122122212112111112222222112212222112122221112121111222212111121122122221
121222222222222221122222222112122221211222122112222112212221122112111221212122112111112212111222111211111222112112221222112121222111212112221121211111
121222222222221222111111112122111121211212221221111111212112222212221222212212212122211212222111222122221111112211111212112112212222122122112121222221
121111111111111212222222222222222221222221112122222222212222131221122211122221222221222211112222212221122222222222222212212222221112222221222222211121
111111111111111111111111111111111111111111111111111111111111111111111111111111111111111111111111111111111111111111111111111111111111111111111111111111
