111111111111111111111111111111111111111111111111111111111111111111111111111111111111111111111111111111111111111111111111111111111111111111111111111111
122222122212222221111111111111121122222211122221222221222131222122222221211222212222221122212222211111111111122222222222222111112222122222221222222221
112212122112111121222222222222112221121122222122211111212222212212211122122212112122122221211221212222222222121112211111111222212112121111121212211121
112112112122221221222222222222122111121121112211112221211121111222111211221112222112111111222212222222222222121212112222211211222112221222121221211221
122112112221121211222222222222121122222221211212222122212121222121222112211121111222312222111112112222222222121212222111222211111131112112122121222111
121212121111221221222222222222121221111111222212111211112122212121212222222222222112112112122222112222222222121221111221111112212222221222212221112221
121222122222111121222222222222121112222222111112222222222211112211221111111111212112212212211112212222222222122221222121122222122121122212111111112121
121211111212122221222222222222122222111112222221211111111111111222121122222222212221222221222221212222222222111121212222221112211221211222222222211121
121222222212221111222222222222121111111111111121212222222222211212122122222222212111111111211222112222222222122221111212221211221212211212222222212221
122111112111111111222222222222121222222222212122212222222222212212112122222222212122222222111212212222222222121112222112121222222212212212222222212121
112112222222222211222222222222221222222222212211112222222222212121222122222222212121111112222111212222222222121222112221221221131121222112222222212211
112112222222222211222222222222121222222222211222212222222222212121211122222222211221222221212222212222222222122211221121212211111111121112222222212221
112112222222222211222222222222122222222222211221212222222222212222212122222222211211111122221112212222222222111122211121212112222222222112222222212121
112112222222222211211111121111121222222222211212212222222222211111122122222222212212222111111221212222222222122121222121212212222222222112222222222121
112212222222222212222222222112121222222222212212112222222222212222222122222222212122112122222121211111111121122221112121211212222222222112222222211121
121222222222222212111111112222122222222222212112212222222222212112112122222222212121212221112122211221222222121111212121211112222222222112222222212221
122212222222222212222212212211221222222222212211212222222222222112211111111111112222211121212211221211211112222222212121222212222222222111111111112121
112212222222222211111211212122211222222222212222112222222222212221212222111111112111111121221221112221212112111111112221211212222222222121112131122211
122212222222222211221221212121121222222222212112212222222222212121212112222122222222222122121121122122212122222222132211111222222222222112221222211221
121212111112111112211122212121221222222222212211211111111211112112212111112122222222222112221122222211112122222222112122221212222222222112122221222121
121212222222222112122211212121211222222222211221222222222222122112132221122122222222222111211111111111122222222222112121122212222222222122111121112221
121122122111112212221212212221211111121111112111111111111112222212212121222122222222222112222222222222121122222222122122211212222222222121222112221221
121221221222211211112212221113222122222222122122222222222212131221212112212122222222222112222222222222121122222222121222112212222222222122212222121121
122211212211212222222112112221212221111212222122222222222212111121222122122122222222222112222222222222122122222222121212112112222222222121111111221221
121121212121211112211222122112211112222211212122222222222212122211111121221122222222222112222222222222112122222222122122112112222222222222122221211211
122221222221222221211211121122111121221121221122222222222212121222222221111122222222222112222222222222122122222222112221222111111211111111221121211221
111121111111111121122212222222222221212223121122222222222211121111111112222122222222222112222222222222121122222222121111112111122222122211212221222121
112222222222222122221121111211111121221121121122222222222212221222211112112122222222222112222222222222121122222222121222222222121212221212212112112211
112222222222222121112211222222222121122122223122222222222222111211222212112111111111111112222222222222121122222222121222222222112211111212112112111211
112222222222222121112221222222222122212122121122222222222212122211111212212222111122212212222222222222122111111111121222222222112122222112122112222211
112222222222222122212121222222222111122111221111111111111112221112221221211112222221212112111111111111112222111222211222222222122121112112122222111221
112222222222222111211121222222222112221222111111111111112212112212122212212221211112212222111122222212222112221211211222222222121322212112111111222221
112222222222222112212221222222222112121212122222222222212112111212211112112121222212211112122212211212111211122212211222222222221121112112122211112121
112222222222222112122121222222222112112212122222222222212222222221222222222111212221212222221222122222122222211112111222222222121121222122121222221221
112222222222222112221121222222222122122122122222222222212111112111111112221222122121222113121111111211111112122222221222222222222221212121122111122111
112222222222222111111221222222222121221222222222222222212122222222222112112212211221111111121222222222222212121111121222222222111121212122112122212221
112111111111111122122211222222222122211212122222222222212122222222222112122111212211221222221222222222222212221222211111111121122212212212112221211121
122221122222112221121121222222222122112212222222222222212122222222222112121222212121212211111222222222222212211221212222222222221212121212221211122221
112121121112122121222221222222222121112122122222222222212122222222222122121212222122222211111222222222222212122121221121211212111212212211122212221221
122122221122121122211111111111111122212211122222222222212122222222222121221122111211311222221222222222222212112222122211221212122211212212211112111121
121111111221221211211111111111122211211221121112111111112122222222222112211121211111111111121222222222222212112112211212122112121122221211222212122221
121222212212211221222222222221121111221121222222211311222122222222222122122121221222222222121222222222222212112221211221222122121221121221112212212211
121211221112122222222222222221221222221122211211222222111122222222222121222221121222222222121222222222222212121112212121111221121112221121222111221211
122212122222112221222222222221211211112221122211111212222111111111121121211112221222222222121222222222222212121122121221222212222222112222212122121211
122112111111222121222222222221211221212121111122222211112222222221222221222112121222222222122222222222222212122221221212211211121111111111112121221211
121222222122122121222222222221211121212212222121111111111111111122112112211222122222222222121222222222222212221111211212122221222222222222212221212211
121213112212221221222222222221222222221222112122112222222222222112122112112211121222222222221222222222222211111313222212111121222222222222211121221121
122211221221221211222222222221211111111112212212212222222222222112221212112122121222222222121222222222222212222222211112222211222222222222211221122211
111122121122212211222222222221212222222211221211212222222222222121112212122121121222222222221121111111111112111212122211111221222222222222211212211211
122212222111112121222222222221212222222211111221212222222222222121112112121122121222222222112221122222111111222122221222221121222222222222211211212211
121122212122212121222222222222212222222212221122112222222222222121222222122112221222222222122122212112222222212121112111122221222222222222211211212121
122221112221222221111211111111112222222212122112212222222222222121211111112211111111111111121211212211111112112112221112211121222222222222212212212211
121112221111111111212222212222222222222212212111212222222222222121212222211222222222221122122212211212222222212222121222212121222222222222222122211211
121112121222222221222111222121222222222211212122212222222222222121211221221111112111122221221122122212222222211111121211222122222222222222212221221221
122212111222222221221222111221212222222211212121222222222222222121212211121111122122212211212221121112222222212212221211111221222222222222211111121121
111212221222222221212212221212212222222212212121212222222222222121222122222222221121221212211112222112222222212112111212221211222222222222211122221221
111221121222222221212121121221212111111112112121111111111111111122121121111111111121121212122211112212222222212222122222122221111111111111112221112211
122121221222222222212122221121222212222222122122222222222222122221121222222222222122121212121222221212222222212111121311112121111222222122222121122121
121122211222222221122122112223111211221121121212211111111112121221121222222222222121221212121221121212222222212121121122221222221211112111111221221221
122211211222222221221121221221222222212221221222111222122212121211122222222222222121211122112212121222222222212122222121121131121212122122222111212221
121111221222222221211221122211111112111112212211222212221222121222221222222222222121212221222122121211212111112111111121122211111212222221112222212121
121222121111111111221211122212222222222212122111211121211111111111121222222222222121222112211221221222212221222221222221111212222211111111112111122211
122212121222222213121222221212222222222212111122211121212222222222121222222222222121111222122221213221212121211122211112221212112212222222222222121211
122112121211221222221111111212222222222212221222122122212222222222121222222222222122212121221121221213222121122211112212212212121212222222222222121221
121222122122212112112122222112222222222211122212212221112222222222121222222222222111212121211121121111211122221212222122222122122212222222222222121121
121211212212221112212221112112222222222211111111211111112222222222121222222222222221222221222122122221221211112212221121111221322112222222222222122121
121222211212122221212212112212222222222211222222222222112222222222121111111111111122111111212212211122121212212122122221222212121212222222222222111121
121112121212111122112112221212222222222211222222222222112222222222121122112222221122222212211211221112122222112121211112211212121212222222222222122221
112222221212222212212111212212222222222211222222222222112222222222122221222111122121122112122212122212211111112122122212221212122212222222222222121221
112121221221111221222222212112222222222211222222222222112222222222111222211122212211112222121112121221222222222112221211111212111212222222222222122121
122121111122221122113111212212222222222211222222222222112222222222121111122221221212221121221222121111111111111111111222222212222212222222222222122211
121212222111121222211112211222222222222211222222222222112222222222122221121111121222122212212212121222222222222211211111121111111112222222222222121221
121222112222121111122221112212222222222211222222222222112222222222121122222222121111111222122121221222222222222212222222222222222112222222222222122121
122221212211122222221122112112111111211111222222222222112222222222121211111112112222222111221122211222222222222212112222222222222111111111111112111221
121211212122211111112222222122222111212221222222222222111111111112121211222212222111112222211222121222222222222212212222222222222122221131222122222221
121222212121222211111111112111212222122121121111122111122222212222121212212111112111111112211211221222222222222211212222222222222121122222212111211121
122111112221112212222222222211211212121122122211222222221211112122121222112222122222222211221221211222222222222212212222222222222222111121112221212121
112122212212222112222222222211221212112112121212212211112212222121221211221112122222222212122121211222222222222212112222222222222112212221221121212221
121221212122112112222222222211112212221222121222121211112112111221211222212222122222222212212221221222222222222212112222222222222111112111222121212111
122211211121212112222222222212222111122211221111121222221122121211221111122112122222222211211111122222222222222212112222222222222122222121212121212221
111211212221212222222222222212111122211112222122222121121221221222121111121112122222222213222222121222222222222212112222222222222121112122212222211121
122212222112222212222222222212211121211222211221121221221211212112221222122221122222222211212212221222222222222212212222222222222121112211111111111111
121111111111111112222222222211222221222211222111121111211222222221112212122121122222222211221211211222222222222211212222222222222122211212222222222211
121122222222222112222222222211121111111111112112221222212111111122212112211223122222222212212212211111111111111111212222222222222121222112222222222211
122122222222222112222222222211222222222222212222121211211222222211222121222221111111121112112111122222221222212222212222222222222122112212222222222211
112122222222222112222222222211222222222222211111212211222221111111111122111122112122222222112222221211112211222112211111111111111112221212222222222211
112122222222222112222222222211222222222222211222122112111121222222222122222112221221111111111211111222222111111212112211222222211122112212222222222211
112122222222222112222222222211222222222222211212121221122221222222222121212131121212222112222222221211111222211212222122211112122221222112222222222211
122122222222222112222222222211222222222222211212122122121111222222222112212222121122112112222222221222211211222212221121122112121112122112222222222211
121122222222222111121111111111222222222222212212112122222221222222222112111121121121212212222222221111222222111122122222221222121222121112222222222211
121122222222222221222211222121222222222222212112222121131122222222222112222122222221222212222222221222112211111111111112121211121112122212222222222211
122122222222222121212222212211222222222222212211111111111121222222222121111111111111111212222222222212221212222222222222121222222222111212222222222211
112122222222222121212121111211222222222222211212222222221221222222222121222222222222211212222222221211111212222222222222222111111112111211122111111111
112122222222222121221221122211111111211111111212222222221211222222222221222222222222212212222222221212221222222222222222112122222222221212222212222221
122122222222222122121211221122221222211311222212222222221211222222222121222222222222222112222222221222122212222222222222112122222222221222121221212121
121112111111111112221211221122122111222222122112222222221211222222222221222222222222212112222222221222211112222222222222122222222222221211221121212211
121122222222221111211222122212112221221212112212222222221211222222222121222222222222212112222222221211122212222222222222121122222222221122212122121211
122221111121122221221112111222111122112212211212222222221221111111211121222222222222212112222222221212221212222222222222122122222222221121122112221221
111111222122212122122212221111222222222111222212222222221122211222212211222222222222212111111112211112111212222222222222112122222222221121221221222121
112222212121112212111221122111112111111122111112222222221211221211211211222222222222212211211122222212121211111111111112112122222222221121211211112221
122111112112221212222122212122222222222121222212222222221211222211221211222222222222211222122212111222121212222211222212212122222222221221222222211121
121111222222121211112211122122222222222121211212222222221222211122222211111111211211212112121222222111221212111212211211222122222222221212212111211221
121222111111322212222222222122222222222121211212222222221211111111111111221222222221222112122111112121122222122222122211111122222222221221112211211211
121212222222121122111111112122222222222122212212222222221211222222222122212211112122122212212212212122111112111111221122221122222222221222211221222211
122211111112122111112221212122222222222122112111112111121221222222222121122222112112121221221222212212122222222222212221122122222222221211221122111121
121222122212212122222121222122222222222121112221222212222121222222222121121111222112111222122111211212122222222212122111212121111111111211122211222121
121111221221212121111121112122222222222111222121211122112222222222222122222122211212221212112221221212122222222212221222212222211122211212211221212221
122112212222211221222121122122222222222122211121221221131111222222222121111221122212122132221121111212122222222211112212231111222221221222122121211121
111222111111121211212122212222222222222121121121121212222221222222222121222212221222112212122122122212122222222211222121211222111112121122221122222121
122212122222221222212111212122222222222121122222121211121122222222222121211111111121222222112212221122122222222212211112222212222212122111111112111221
121112121112113111122111221122222222222122211112221212221221222222222112212222222221211111111111112112122222222212122221311112121122212112222222221211
122212121212222222121221121111111211111122112221112212112211222222222112112222222221221222222222212222122222222212121122122212212221212112222222221221
121221122211112212121121322222212222211222222122112112112121222222222222112222222221121222222222211122122222222212122212221221212111222112222222221121
121122112222111221121221122111112111222111111212222222122121222222222121212222222221221222222222212222122222222212211221111122112212111212222222221221
122212131112122122221212212111222221112211111111111111121121222222222122112222222221211222222222222112122222222212221121222212221221222112222222221211
111212222212121111222222112222213121221212222222222211221221111111111112112222222221211222222222212112122222222212122222211221221122112212222222222211
121211121212122221211111111111111122212212222222222211212212222212222212212222222222211222222222212221111111111111111121111111211212211212222222221221
122212221112221122112222222222222112122212222222222211221222111222121211212222222221221222222222212122221122222221222222222221212211222212222222221121
122122212221112212112222222222222122121212222222222212122111211111221222211111221111111222222222212111212221111121222222222221222122111211111111211121
121221212122222212112222222222222111221212222222222212112222122222212112222222222122221111111211112221212112212222222222222221212121112212222211222221
112212122122111212212222222222222222212212222222222212221112121211111111111211212121122221111222221111222111212111222222222221212222222122111222122121
112111221112111122212222222222222121112112222222222212121122121212222222222212211221122122222121112221221221212211222222222221221111111221122112112211
112221211222122211212222222222222122212112222222222222122121221212222222222212121212212211112122222121222122221221222222222221122121112211221112221221
121121221211121221222222222222222111212112222222222212112121221112222222222212221221211212212211211122112221111121222222222221212122222122212221121121
121222121221221122212222222222222122212112222222222212212122122212222222222211122122211221211211212212211112222121222222222221212111121221112122221121
122211221121212211112222222222222121122111111111111211212212111212222222222212212111222121212222212112222112112221111111111111222222221221122111111121
121111211122212131112222222222222121222112222222122212212212222212222222222212122122211221222111122222112122122211111111111111111111112122221222222221
122222222211112222211111111111111122112122112212121221112111112212222222222222121121122211111111111111222121211212222222222222112222212221112212211221
121111111111111121211222122212221212111121211212122122212221111212222222222212122122121212222222222221211221222212222222222222112111212212111111221121
121211122222222121222212221222122212222221221211112211211122222212222222222212222212211212222222222221222211221112222222222222122121212112222222121221
121222122222222121212211223111111111111111121222221221222112111111111111211111112211212212222222222221111122221212222222222222121221212111112112221211
121112222222222112211222121122222222222112223111122121112112212222122222221222212122212112222222222221222121122212222222222222122211222222222221111221
122222122222222112121221221122222222222112122222212221212221212121221211121211221121112112222222222221212221112212222222222222121111111111211111111111
111112222222222112121121222222222222222122112211221112211122122122211222212222122221122112222222222221211112221212222222222222121222222222212222222211
122212122222222122122121112122222222222121211221112222121112221111111111222111111112222212222222222222222212121222222222222222121222222221212222222211
121222222222222121112122212122222222222121221122222122122211111222222222211222222212111212222222222221211112121212222222222222221222222221212222222211
122111122222222122212112221122222222222222121111111222212222211222222221222112111212221211111112111111211222121112222222222222121222222221212222222211
112111111111121111222212121122222222222112121221222221212121211222222221112122121221222122222222222221122211122212222222222222121222222221212222222211
122122221122222211111221121122222222222222222212211121211221211222222221122121322121212222111111112122121122111211112111111111121222222221212222222211
121221121121221222221112223111111111111111121112122212212211211222222221221221122221111212122222222112121212221222222221222122221222222221212222222211
122111223121211111122222121111221222222222121222121112122111221222222222212212121111222212122222222111121212121221111121212221111222222221212222222211
112112221221222222211111221222212212211112111211221222121222121222222221112122121222211112122222222122221222121122222121211111121222222221212222222211
122112121212111111211221212211122111222212222212221211122112121222222221222121221212111222122222222221111211222211112112212222221222222221211121111111
121222111212221121221212212111221222111211111122121221212112221222222221211222211122122211122222222121222211211212222122122111121111111121211122122221
121221122222121221121212112222212212112211222221121121222211111222222221221111222221121122122222222121221112222122121221221111322211222222122212221121
122122221111222211221212211221122122112122121112221221111222221222222221122222111111122222122222222121122212112121121211212222121122211112221221111121
112122111222111122212212222112221121222112222221112212221111121111121111111112221122211112222222222222211221122122212212212112221121122211111122112221
112111222212221221112112112222112122121212111121122122122221222112222122212221122221222221111111111121222121121211222222122121111221221221222212122121
112222211121122212222222221111222222221222222122222221211122212222112221222122211112111122222222222222112221222222113111222222222212222122211222221221
111111111111111111111111111111111111111111111111111111111111111111111111111111111111111111111111111111111111111111111111111111111111111111111111111111
