111111111111111111111111111111
122222222222222222111111111121
121111111111111112122222222121
121122222222122222122222222121
122122222222121122122222222221
112122222222122211122222222121
122122222222121222122222222121
121122222222121212122222222121
121122222222121212122222222121
122222222222122112122222222121
112122222222112122122222222121
112122222222122121122222222121
112222222222111122122222222121
122111111212122212111111111121
121122112222221212111111111111
122121222111111222212222222211
121222211111111211212222222211
121211212222222212212222222211
112212212222222212112222222211
112122112222222212112222222211
122121212222222212212222222211
121222212222222211212222222211
121112212222222211212222222211
122211222222222211211111121111
121222112222222211221222222221
121112112222222212122112211121
121222112222222222212122122221
121211111111111112222221121111
121222222122222222113112222221
111111111111111111111111111111
