111111111111111111111111111111
122122222222224222241222212221
121121111122141212122242222121
124121222212222212221122111221
121122121221112441111111112221
122222221122212222222222212121
121111121111112222222222212121
121222222222112222222222222214
122222222222112222222222211211
121222222222112222222222211224
124222222222142222222222512121
124222222222112222252222211224
121522222222412222222222242221
121222222222142222222522242121
121222222522112222222222242124
122222222222115222222222212211
121222225222411411412111112221
121222222222122222222222222121
121222222522441144111121111421
124222222222112222222222222121
121111114241112222222222222121
121222242224212222522222222121
122121112421212222222222222121
112224222121242522222222222121
111121211121222222222222222121
122121211224212222222222222124
121221214221212222222222222124
121241222122241111111111142121
122222112211222222222222222221
111111111111111111111111111111
