111111111111111111111111111111111111111111111111111111111111111111111111111111111111111111111111111111111111111111111111111111111111111111111111111111
122212222221222111112222221222222221222222222122222222211111111111222212212222222222222222222222221122212222221111112221222222222211111313111122212211
121222111122212222212122112212111121111121112111221111212222222221211221212111111111111121221111121121122122112222222122211112111222222222222221221221
121111111111111111222112222112222122222221222222212212212222222221212222212212222222222122122222121223121212222111111111111122222111111212211112121121
121222222222222111111111111111112212111111111111111212112222222221221111221212222222222112111112122221221211111212222222222111111111111221212222121221
121222222222222122221222222222211212122222222222212212112222222221121122221212222222222112212222112121212222112212222222222112222222221112212221221211
121222222222222121121222222222212212122222222222212112112222222221122121112212222222222121212111212212212112222212222222222112222222221222122122222211
121222222222222112221222222222212112122222222222212122112222222221212112222112222222222121212221222212112221121212222222222112222222221211111111111111
121222222222222112111222222222212212122222222222212221212222222221222212111212222222222122221121111122111112221212222222222112222222221212222222222211
121222222222222112211222222222211211122222222222212112212222222221211222222212222222222121221221222222222222111212222222222112222222221212222222222211
121222222222222121211222222222211222122222222222212222212222222221221111112212222222222112212221211111111111112212222222222112222222221212222222222211
121222222222222112211222222222212112122222222222211111212222222221121222111212222222222112122121222122222222212112222222222112222222221212222222222211
121222222222222112111222222222212212122222222222212212212222222221212212221212222222222122121221212122222222212112222222222112222222221212222222222211
121222222222222122221111111111111212122222222222212122112222222221222111121212222222222121122111221122222222212212222222222111111111111212222222222211
121111111111111121122211221222222212122222222222212122211111111111122122121112222222222121112221121122222222211212222222222121122212222212222222222211
121222221222221121121222221211121122122222222222212221122222113112221121122212222222222122221122222122222222211211111111111122121212111212222222222211
121211121122122221221111121222121222122222222222211112121211222222112122211211111111111111111111111122222222211222122221121112221212122211111111111111
122211122121211112211222111211221212111111111111111112221221212111222221222222222221222112222222221122222222212112221122212221121222121212222222122221
111122112121222221221212122212212212221222212112222222222121212221211111111111111121212212222222221122222222212221211111212122121211121212121112112121
111112212121221121112212221122112121121211221222111111111122221121212222222222222121111212222222221111111111112122212221212112121221221212122112122121
122221212122211121132221111121122122122212221211122222222122111122112222222222222121222212222222221221131221122111122122112212122112211211112122121121
121122212122122122212112212221221212111122112212122222222121222212212222222222222121211212222222221212222212221122221212221212212122111212222121221221
122112212122112211212222122212211122221221222122122222222121211211212222222222222121221212222222221222121122111221111211121221212121222222111222212211
122211212212222122222221221212122221112212211121122222222111211211212222222222222122121212222222221211122121221211222211122121221221211111111111111121
121211211221111111111111211212122112222122122222122222222122212211212222222222222112121112222222221212212221212212211222222221122212212222222222222121
121211222121222222222221211212212222111221221112122222222121112111212222222222222112122211111111111222221112212122111111111111111112112222222222222121
121221112121222222222221211211221121121211212122122222222121212222212222222222222122111221111111111111121222212121221222222222222212212222222222222121
121122122121222222222221211211122122221211222121122222222121221111112222222222222121111221222222222221122121212121121222222222222211212222222222222121
121112211221222222222221211222112111121212211223122222222121122222212222222222222122221211222222222221212121212122121222222222222212212222222222222121
122211211211222222222221222112212222121221122221122222222122111211212222222222222111121211222222222221222121212212121222222222222212112222222222222121
111211211221222222222221112121211112111122221121122222222122211221112222222222222112221221222222222221211221211212221222222222222212212222222222222121
112213222121222222222221222121212212122211112122122222222121221122211111111111111122111121222222222221212121211211121222222222222211212222222222222121
112121212121222222222221211222222112221222222112122222222112122111221122222221112221122221222222222221221221211212221222222222222211212222222222222121
132221212121222222222221211111111111111222112212111111111122112222122221221112221121121221222222222221122211211221121222222222222211212222222222222121
112112212121111111111111222212222222212212211122112221222221121112212112122122121221221211222222222221211111222122121222222222222212211111111111111121
112122211221122211122222111212222222212121211121122121112121222121212222112221121222112231111111111111122222112212211222222222222212111222212222222121
122121212212121122221212222212222222212221222222221222222122212221211111111112221211222212222111222221121112122221221111111111111111222212122111112221
121221212112222221111221112212222222211211111111111111111111111111212222222212111211211221112221211122221122121112121122211122222222211112222222221121
121212212211131112222121221212222222211212222222222221122222222221212222222212211221211122212122231112111221212221122221222221111112122111111111111221
112211111211111122112221212212222222212212222222222221122222222221212222222211222122212211212111212222122211222121221111111111111112222122222222221211
112112222222222221221111212112222222212112222222222221122222222221212222222212212211112121221222112111221122212122111222222222222211112122222222221211
112212111111111112221112212112222222212212222222222221122222222221212222222212111111122221122212112122221111212212211222222222222211212122222222221221
122222112222222212122212112212222222211212222222222221122222222221212222222212222222121222211112222121122222121211211222222222222212212122222222221121
121111212222222212211222221212222222212212222222222221122222222221212222222212111212221111111122111111111112221211221222222222222212122122222222221221
122111212222222211222111112212222222212112222222222221122222222221212222222212221221112221222121122222222211221212121222222222222212121122222222221211
112222112222222211212222112112222222212112222222222221122222222221212222222211121122222122212221122222222212122212121222222222222212121122222222221221
121112112222222212211112122112222222212212222222222221122222222221212222222211221111111111111112122222222212111122221222222222222212221122222222221121
121112112222222212122122122211111111111212222222222221111111111111211111111112211222222222222212122222222212222121111222222222222212211111111111111121
122222112222222212222121221212222221221212222222222221122222222211222221112212121222222222222212122222222212112121221222222222222212122221222212221121
121111112222222211112121222122111121212212222222222221221111221221221122221222211222222222222212122222222212112121121111111111111112221212211221122221
122212212222222212112122211221221121212112222222222221212221212112211111122111211222222222222212122222222212122122122222211111222212111212121122112111
111221212222222212222111112211122121222211111111111111212212212222112222112122211222222222222212122222222212122212111121212222211211222122122212112221
121121212222222212211222112122212121211122222222222122211212112211222112112121111222222222222212122222222212121122222221222111122211212121121222111121
122121212222222211112212212121212121122211112111112111221212222112211112212212221222222222222212122222222212122121111111111122221112212221221111122221
122222211111111112222111212221212221121212222122112221122221111222122222221222121222222222222212122222222212211121122222222121111222121112222222221121
121111211222112222111221211112212111221212111122221121111122122211111111111111121222222222222212111111111111212221122222222122222212111111111111111221
121221122212212121111122222222122222212212122221121122222112121212222222222222121222222222222212212222212221212112122222222111111112112222222222221211
122121121111221221222112111121111111111222121212122111112112211212222222222222121222222222222211212121112122212122122222222112221122112222222222221221
112121121222122211212221112221222222221111212212212122212221222212222222222222121111111111111111222122222211222121122222222122122121212222222222221121
112121122212211112211122221121222222221222212121212221221122111212222222222222122211122222222222111111111111211222122222222121211221212222222222221121
112122111121222222222211122211222222221111212212231111122112111212222222222222122122211211121112122222222221211212122222222122122211212222222222221221
122122221111111111111212211211222222221222221222211122212122122212222222222222112121211212121122122222222221212212122222222122221111212222222222221211
121121121222222222221211211221222222221211111111212221222121121212222222222222122121222222122212122222222221221122122222222121211222212222222222221221
121122121222222222221212222121222222221211222212212111111122211212222222222222121121111111111212122222222221122121122222222121211211212222222222221121
122211221222222222221222112121222222221222211222112222122211211212222222222222122221222222221221122222222221212122122222222122122211212222222222221121
111212221222222222221122221221222222221211111111111122221221212212222222222222112211222222221121122222222221212212111111111112221122212222222222221221
122212121222222222221212112221222222221211222222222121112122212111111111111111112111222222221221122222222221211222222111111111111111212222222222221211
121122121222222222221222112121222222221221222222222122121111111111121122122222212221222222221212122222222221221111112112222222222211211111111111111221
122221121222222222221221212211222222221121222222222112121222222222112222121122211121222222221221111111111111122222212212222222222212221122221122221121
111112121222222222221222212221111111111121222222222122121222222222112112121121211121222222221222221222122222221111221212222222222212121121212221222211
122212221222222222221211112122212222211221222222222121221222222222122221221221212221222222221212111212111112121112221212222222222212212221222112211221
121222211222222222221212221221221121221211222222222121121222222222121112212212212111222222221122122212222112122212111212222222222212122111111111111121
122111111222222222221212121222121121112211222222222122121222222222122212122221122111222222221221221121112221121212122212222222222212121212222222221221
112112221222222222221212121211221122112111222222222112121222222222121222121112221221111111111211212211221122121221221112222222222212122212222222221211
122122121111111111111212121221212212112221222222222112121222222222111111221122111122221222211221212222221212111122212212222222222212112212222222221221
121221221222212222211112121112211222221121222222222122121222222222122221212221222112122211222121212112121212222211222111111111111111221212222222221121
121212211111212111222212122212122221112221222222222121121222222222121122212111212222111122112122211222122231111211111122221222222222212212222222221221
122212222222212211111212211212121212221121222222222121121222222222122212122122211111112221112211122211211211221222222221122211212111212112222222221211
111111111111111212221211212212121222122221111111111122221222222222121212121221112222222212222222221122222231211111111111111111212222112112222222221221
112222222222221222121212212112111111111111111122222211121111111111121221221212222122111212111111111111111213222122222222222221221112112112222222221121
112222222222221221121222112122212222222222222121211221121212221222122121212212111112221212212222222222221211212122222222222221112222122111111111111121
112222222222221222121111222121212222222222222121212122121222122212222122212122122221121211212222222222221221212122222222222221222121221212222222112221
112222222222221211221222211112212222222222222121212222121111111111111112122121221121121221212222222222221121122122222222222221211221211222121112221121
112222222222221122212211122222112222222222222121221121221122222222222212121122212222122112212222222222221122222122222222222221211211212111221221121121
112222222222221221122222221111212222222222222121122121222122222222222212121111111111112212112222222222221211112122222222222221222122212112211222121221
112222222222221211111111112222212222222222222121112121212122222222222212221222222222211212212222222222221122222122222222222221112121122222122212221211
112222222222221212222222212122112222222222222122212211221122222222222212111222222222211221212222222222221121111122222222222221222122121111111111111221
112222222222221212222222212121112222222222222121211221121122222222222212211222222222212222212222222222221221122122222222222221211112221222222222211121
112222222222221212222222212122212222222222222121212121221122222222222211211222222222212111112222222222221211222122222222222221222221121222222222212221
112222222222221212222222212211212222222222222112212122212122222222222211211222222222212212212222222222221211212122222222222221212121121222222222212121
111111111111111212222222211122212222222222222112122211112122222222222211211222222222211211212222222222221212212122222222222221212122121222222222212211
122222212211111212222222212221212222222222222112221212222122222222222211211222222222212212211111111111111222122111111111111111212112121222222222211211
111211222122221212222222212112212222222222222121112212112122222222222211221222222222212122122212222222222111221222112221222221112221121222222222211211
122211211221122212222222212211111111111111111122212122212122222222222211121222222222212212121222111121112222112212222122211122221122221222222222211221
121122221212211212222222212222221222222122211221212211221122222222222212221222222222211212121111122212221112212111111111121111122112111222222222212121
122121112212112212222222212111212212211221222211211221121122222222222212111222222222212212122222221222122211222122222222122222212212121222222222212221
112122212122122212222222212122212121222222112112212122121111111111111112221222222222212122111111112111211222112122222222121122122212221222222222211221
122111112212121211111111112121112212111111222122122112221222221222222221121111111111112222222221111111111112122122222222121112211211221111111111111211
121222221222122112222212222122222222112222112122222211121112122211111221221222221222221111111122122222222212121122222222122221211221112221111122211211
121211122222212222111221111111111111212112212121111222122221221112211212212211121222122122222112122222222212122122222222111121222222222122222221222211
121211111111111111111121222222222221212121212212221112211121222212122212122122121212111221112222122222222212212122222222122221111111111111111111111111
121221222222222222212221222222222221222221221222122211122221111222121221121212221112112212221111122222222211221122222222121112122222222222112222222211
122121222222222222212111222222222221221112121111121221121112221211221122221222211222122122122212122222222212122122222222122221122222222222112222222211
112121222222222222212211222222222221222222122222122122121222122122211111111111212211121121211212122222222212212111111111111121122222222222112222222211
132221222222222222212221222222222221211111111112112212222211222221112222222212212111221121212222122222222211212112222212221122122222222222112222222211
112111222222222222212121222222222221212222222212221111111111111111212222222212122122222221222112122222222212212212121222122222122222222222112222222211
112121222222222222212121222222222221212222222212121222122222222221212222222212121221111111111122122222222212111221121111111111122222222222112222222211
122121222222222222212121222222222221212222222212122212122222222221212222222212122211222222221221122222222212222122121222222221122222222222112222222211
121221222222222222211221222222222221212222222212211122122222222221212222222212121121222222221212122222222212212112211222222221122222222222112222222211
121121222222222222211211222222222221212222222211221222122222222221212222222212122221222222221222111111111113122111221222222221111111111111111111111111
121121222222222222211211111111111111212222222212112212122222222221212222222212111221222222221122222122222222221222121222222221122222212222221222122221
121221222222222222212212222122212221212222222212122112122222222221212222222212112221222222221213112211121112112212221222222221121121122122122212212221
122221222222222222212112112221222122212222222212221112122222222221212222222212221121222222221222221222122212212112221222222221121122121212111111212121
111121111111111111112222211111111111212222222212112221122222222221212222222212121121222222221122121112211211212212121222222221121212121212221222222121
121221121111111111111111212222222221212222222212212121122222222221212222222212122211222222221121112221212211211211221222222221221222121221122111111121
121211221222222222222211212222222221212222222211212121122222222221212222222211211221111111111322222121211122231211211222222221212111222222112211222211
121222211222222222222212212222222221212222222212212121122222222221211111111112221121222222222121111122222221211222111111111111221122211112221222211211
121111211222222222222212112222222221211111111112122122122222222221211222221112122122111211121221222122111121222112222212222222122221111111111111122221
122221211222222222222212112222222221212222212122222212111111111111212211122222111212212211122211212121112221112212111221122112121111222222222222121121
121112211222222222222212212222222221212111212221111212222111222222222222211112222231221122211122212112221112221122122122221112122111222222222222111221
122212121222222222222211212222222221212121221112221221112222111111111111111111121212221221221221212222122222122221112211112222112221222222222222122221
121222221222222222222211212222222221212121121222122122221112122222222222221222221221121212121211221111111111111112222221122111121121222222222222121121
122111221222222222222212212222222221112122121211112111111112122222222222221211112223121211221221121222222222222212112121221222221121222222222222122121
112222111111111111111112112222222221222112222212222222222212122222222222221221221121221211212121221222222222222211222112212122112221222222222222112111
121211222122211222112221111111111111211111111111111111111222122222222222221121222121212211212222121222222222222212211222112221122111222222222222132221
112211212221222212222122222222222222212222222222212222122112122222222222221221212221222112211112121222222222222212111211222122121221222222222222112121
112122211111111111111121111111111111212222222222211212212212122222222222221211111111111212122222121222222222222212222212211212222221222222222222112121
122121212222222222222121222222222221212222222222212211211212122222222222221212222222211212212111121222222222222212111111111111111121222222222222112121
121122112222222222222121222222222221212222222222212122222212122222222222221212222222212211212211121222222222222212112222222222222121222222222222112121
121212212222222222222121222222222221212222222222212111121122122222222222221212222222212111221222121222222222222212211111111111111121222222222222122121
122211212222222222222121222222222221212222222222212221221121122222222222221212222222212221121112211222222222222211211222222222221121111111111111121221
121122212222222222222121222222222221212222222222212121211121122222222222221212222222212122122212221222222222222212211222222222221122212211222122111211
121221212222222222222121222222222221212222222222212122112221122222222222221212222222212212111212121222222222222212111222222222221111212122212221222211
112212212222222222222121222222222221212222222222212212212112122222222222221212222222211212221211221222222222222212111222222222221121212221111121212121
112122112222222222222121222222222221211111111111111211222222111111111111111212222222212211122212211222222222222212211222222222221122222112222221212211
112121212222222222222121111111111111122221222222222221111111111111122213112212222222212122211122111111111111111111211222222222221111111111111111221211
122121212222222222222112222211312221221222111111111111222222222222121222222212222222212121222221222222222221222111211222222222221112222222222221121221
121122211111111111111112122122222122212212122222222211222222222222121222111211111111112221111111111111212212212122211222222222221112222222222221121121
122211212222221121222222112221211112221112122222222211222222222222121212111122222122221221222222222221211222112121111222222222221112222222222221121121
111211212111122221211111211112212221112222122222222211222222222222121221222221212121122121222222222221212111222122211111111111111112222222222221121121
112211212111111212222112122212112121222112122222222211222222222222121122211211211222212121222222222221222112212211211111111111111112222222222221121221
112112222122211212111222121221122121211222122222222211222222222222121111131212211211112121222222222221122122122221221222122222222212222222222221221211
132221111221212212222211121122221121221112122222222211222222222222122212222212112212222121222222222221112121211222121212221111121212222222222221211121
112121221212212121112212121111111122122221122222222211222222222222121212121122122112112121222222222221222121222211221211111222121212222222222221222211
112121122212112212221212122221222212121121122222222211222222222222122122121111221212221121222222222221211122121112222122221212121212222222222221211221
112122211212222212122212211122121112122121111111111111222222222222112121212221212212112221222222222221212212121222111221121212122112222222222221221121
112111212211111212111121211112122212211221222221122211111111111111122121212121212112222111222222222221222112212211222211221212112111111111111111121121
112211211122222112111121222222121211212212121112221222112221222211221122212122222221111121222222222221121121212122211111212212122211111112221222112221
122221222221112222222222111111221222222112222222112112222122211222222211222211313122222221111111111111122221222221122222222112221222222222122212222111
111111111111111111111111111111111111111111111111111111111111111111111111111111111111111111111111111111111111111111111111111111111111111111111111111111
