111111111111111111111111111111111111111111111111111111111111111111111111111111111111111111111111111111111111111111111111111111111111111111111111111111
122122222222222211222111122212222212222221122222131122112221113111222222212222222122211112221111112222211112222112222222221122222221111221222122222221
112121111211111222212222221212121122112122211212222221222122222221212121122111221121222222122222222121222222112222111111122121122112221212212221221111
132221222222221211111111111222122222212211222121121221211122112122212212221222121221111111111121111221111121111121112221312221112222122222221112122221
112111222222221222222222222112111111111211112221121121122211112211111112112212122212212222222222221212122222222122212122221112221111211111111111111121
112121222222221111111111111212222222221212222222221122221222221221222212221122311121212222222222221222122222222111221221212222112221212222222222221221
122121222222221122222222222212222222221212111111111121112111122122211221121222122211212222222222221112122222222122122111222122222121212222222222222211
121221222222221122222222221212222222221221122222222222112222112211222121121212121212212222222222221212122222222112112111111221211221212222222222221221
121211222222221122222222221212222222221121122222222222122112121221212121122212221222112222222222221222122222222132212222222111211211212222222222221121
122211222222221122222222221212222222221122122222222222121112221121212122212111111111112222222222221211122222222112221111112122211222212222222222221121
111221222222221122222222221212222222221212122222222222122221112221122111212122222222112222222222221212122222222112122222212221122111112222222222221221
122221111111111122222222221212222222221122122222222222221122221122121121222122222222112222222222221212122222222122111121212111111111112222222222222211
111111111111112122222222221212222222221222122222222222111122122212122221111122222222112222222222221222122222222121221221212122222222112222222222221211
112222222222212122222222221211111111111212122222222222122211211212111221222122222222112222222222221122222222222121212211112122222222112222222222221211
112222222222212122222222222222212222122212122222222222121211211222122121122122222222112222222222221212122222222222212112222122222222112222222222221211
112222222222212122222222221211212112121221122222222222121212221121112222121122222222112222222222221222111111111111212222121122222222112222222222221221
112222222222212122222222221211221222121122111111111121121222122122211112223122222222111111111121111112222111111111111111221122222222112222222222221121
112222222222212111112111111221122112122212211222222221221111112211222211121122222222111121222122222121112122222222222221212122222222111121111111111221
112222222222212131112222121121212112111221221211121211212122221221111212223122222222222212212221212221112122222222222221222122222222122222212222222221
112222222222222222221212212221212212222222121211121221222121122121211211121111111111121212111111211221222122222222222221122122222222121211221121221121
112222222222211221122211222112221212111131221222212122112122212221221222121122212222221221222211213112211122222222222221212122222222121212212221121121
111111111121112211111111111112121212122212222111222112122111211111121112112221211121112122211221222222122122222222222221212222222222121212112112122211
112212222122222112222222222222121212111212112212112212221111222212222222222111222221222211113122112111121122222222222221212122222222121221112112111221
112122112221122112222222222222122212122212211221221221111222111212111121111111111212211212222212112111122222222222222221212111111211122122222222222121
132221111111222212222222222222121112221221221121121122222212221212122222222222221211122212112122112122212122222222222221222212122222211111121111112121
112112222221211212222222222222121211112122121221121111111121121221122222222222221122221122112121212121222122222222222221211221221112112222222222122121
112112111121211212222222222222121222222112121222221222222121121122222222222222221121121221112221222221122222222222222221122121212222112222222222121121
112212122221221212222222222222121221112222122112111211212212222112122222222222221322212211221111121111112122222222222221121221122122312222222222111121
121221121111122112222222222222122111111112112122122211211112131222122222222222221121212122211222222222212111111122111111122222221222112222222222122221
121122221222112212222222222222112122222222212111221122222222212211122222222222221121112221211222222222211122221222222111111111111112212222222222121111
122212112212111222222222222222112122222222212221211111211111112122122222222222221322221112211222222222212221122112112212222222222211222222222222122221
121222112112122212222222222222112122222222212121211222222222212212122222222222221121121122111222222222212112222222122212222222222212212222222222122121
122111212122121212222222222222122122222222211221221222222222211212122222222222221221121121221222222222212111111111111212222222222212112222222222121221
112122212121121212222222222222121122222222211211121222222222211212111111111111111211221221121222222222212122222222211212222222222212112222222222112211
112121122121221222222222222222121122222222213222221222222222211212112222222212111112221211122222222222222122222222222212222222222212112222222222112111
122221221122212211111111111111122122222222211211111222222222212212212112211221222222121222221222222222212222222222212112222222222212212222222222112221
121112211111111112221122222211212122222222211221211222222222212112222121221112212211111111221222222222212122222222212212222222222211212222222222121121
122212112222222212112221111222212122222222212121221222222222212122121121121222112112222222121111111111112122222222211222222222222222211121111121121121
111212212222222212222112111121122122222222212122121222222222222211222121122212212112121112122111221122212122222222211212222222222212112222222222222221
122211212222222211221211222122121122222222212212121111111111111222112221211122212222121122112221212221212122222222211212222222222212221222112111111111
111122212222222211211222212212222122222222212122121122122212222112211121211111111212212221221122222112222122222222212211111111111111121212122222222211
122212212222222211211221111112111121111111112222222212121222112221222121212222222211112111111111111111311122222222212111211111111111111212122222222211
121222112222222222211211222222221122111111111111111212122111111121112121212222222212222121111111111121221122222222212222212222222222221212122222222211
121122312222222212111221222222221222222222222122122212112122222222222122212222222212112221222222222121222122222222211112212222222222221212122222222211
121112112222222212221121222222221212122222222121221122112111111111111111112222222212122121222222222121212122222222212211212222222222221212122222222211
122212212222222211121221222222222211122222222222211121112212222222222222112222222212121121222222222121212122222222212222212222222222221212122222222211
121221212222222211221211222222221222122222222121122222211212222222222222112222222212122221222222222121212111211111112111112222222222221212122222222211
122122112222222212211221222222221112122222222121111221221212222222222222112222222222112121222222222121122221221222212122212222222222222211122222222211
112112212222222212222121222222221112222222222122221121121212222222222222112222222212122121222222222121121122212211212211212222222222221222122222222211
132221212222222211112221222222221222122222222112122221112212222222222222112222222212212121222222222121122111112121221212212222222222221112122222222211
112112211111111112221222222222222212222222222112211111222212222222222222112222222211212121222222222122222221222221211212112222222222221222122222222211
122122222222122122121121111111111221122222222121112221211212222222222222112222222211221121222222222221211122213121221212112222222222221211111111111111
121221211112221221121122212222222122122222222122222121221212222222222222112222222212121121111111111121222111111122121222111111111111111222222221222211
121211122221112211121211221122112112122222222112211221222112222222222222112222222212223122222222222221212112222112121112222112222222221211122121211221
121222221122222112221222222221212222111111111112122212212112222222222222111111111111221111111111211111211222112121222121112122112111121111112122121121
122111111111111112111111121111221112112221122222121111122112222222222222121112222211211222131122222222211211222121212221212121222122222222222112212221
112222222222222212122222222221122212112122221111121222121211112111111111112222111212222112222211111111211211211122211222212121211111111111111221212121
122222222222222212122222222221111212221122112222122212221222222222222222222111221222112111121211222222221212211221222131212121222122222222122221222121
121212222222222222122222222221222221121121111112211112111111112111111121111111121111222122221211222222221212222211211111212212112122222222121122121221
112212222222222212122222222221211121221122222221222122222222212122222222222221222111211121111221222222221221111121212221211212222122222222122212121211
112112222222222212122222222221222121211221111122112122222222212122222222222221212221222122112221222222221121222121212122122211221122222222111212212211
112112222222222212122222222221212112211212221112112122222222212122222222222221221121112212221121222222221121212122212212221122212122222222122231122121
122112222222222212122222222221212222122222112222112122222222212122222222222221121222221212121121222222221221221221111221111221112222222222121212221221
122212222222222212122222222221211111221111222111222122222222212122222222222221221111112211121221222222221212121212222122222211222122222222121212112221
111111111111112112111211111111221111112222211222212122222222212122222222222221212221222212221211222222221221121222211111111111211122222222121112212121
122211222211222112122222221122122222222111112211122122222222212222222222222221212122211222112211222222221121322111212222222221222111111111122221222121
121212211221212222121212122222111112111111122111121122222222212122222222222221222121111211111111222222221121121222212222222221212112211221221122111221
121222122222211111112212111112122222222222121222121122222222212122222222222221211122122222222121222222221122122211112222222221212222122211212112221211
121111111111111112221112122222222222222222122212121111111111112122222222222221211112122222222121111111111212211221212222222221122122221122212211121211
121122222222212222122222121111122222222222111112122122222222222122222222222221212221122222222111111111111111221121212222222221121211121221121221221211
122122222222212111121112111111122222222222122212212221111221121121112111111111212121122222222112222222222221121121212222222221121122212212121121211221
112122222222212111121222222221122222222222121221221112111122121222122212221222122122122222222112222222222221221122212222222221122121222112222221221121
112122222222212122211222222221122222222222121122121221222212212212221212121212221112122222222112222222222221212111212222222221112122111111112122122121
112122222222212221221222222221122222222222121212121122211211222221111222122221112222122222222112222222222222212222222222222221222112122222212212212121
112122222222212112121222222221122222222222122212222211122222111121111111121111222112122222222112222222222221221111112222222221211112221111221221212221
122122222222212111221222222221122222222222111221131222221312222211222222222221211112122222222112222222222221121222212222222221222221111222122122121111
121122222222212122221222222221122222222222122211111111111111111211222222222222212222122222222112222222222221122211212222222221212211221212212112221221
122122222222212121121222222221121111112111121112222222222222121211222222222221221111122222222112222222222221211111212222222221211222211221212222121121
112111111211112122211222222221222221222222122212222222222222121211222222222221222221111121111112222222222221122222211111111121212212211121221111221221
122122222221122111221111212111212112212112211212222222222222222211222222222221211121312222222211111111111121121121111111111221122122122221122222212221
121121121112221111122222212221212112112221221212222222222222121121222222222221211122222111111111111111122222221222222222212212221221121111111111112121
121221122222112222211111222122212212121121112212222222222222121221222222222221222112212122222222222221221111211222222222222112122112121122222222122121
121222211111222111211111111111211212221121222112222222222222122211222222222222212112112122222222222221211221211222222222212112112211221122222222121121
121111111222112221212222222222221221211221211212222222222222111111222222222221221222112122222222222221211212211222222222212222211211212122222222121121
122221222212122112212222222222221211212211222212222222222222122221111111112111111211212122222222222221222212121222222222211111212212212122222222122121
111122211112222212112222222222222221212131112211111111112111121121111122222222222211222122222222222221111212221222222222222222122122112122222222112111
111111111111111112112222222222221122212222221212222222222212221221222221211112111111111122222222222222221212211222222222212112121121222122222222112221
112222222222222112112222222222221322111121212212111122121122211211211111212222222222221122222222222221121211211222222222212112221221212122222222122121
112222222222222112212222222222221121221121212122122212121121212211211222212222222222221122222222222221122212211222222222212221111211221122222222121121
112222222222222111212222222222221221121121112211221222121122122212211212212222222222221122222222222221221112111111111111112122211212222122222222121121
112222222222222122212222222222221222221122222222212111121212211221111221212222222222221122222222222221212112222221111222212211222212112222222222112221
112222222222222121212222222222221211111111111111111222121211221122222121112222222222221122222222222221221221221112221211211222111122122111111111112121
112222222222222121212222222222221211222222222112222212122211122211112122212222222222221122222222222221121212122222122211222112211221222212222122222121
112222222222222122112222222222221221222222222122112121121122221211212211212222222222221122222222222221221221111111111111112211212212211221212211222121
112222222222222222212222222222221122222222222121222122221121111122231211212222222222221111121111111111212121222222222222211211221112122121221212212121
111121111111111121212222222222221221222222222221211222112221222221211212212222222222221111222112221221212221222222222222212222122112112121121222111221
122222111222222211211121111111111211222222222121112211221121211221221212111111111121111222212112121122211121222222222222212112112222112222221111221211
122211222212211212211222222212211211222222222122222112212221212122112212222212222222112212112122122122212221222222222222212212111111111111112221121211
121221211112122222121211111221211211222222222121111122212111222112222211222122112212222122122121212111222121222222222222211212122222222222122122121221
122122222212211311122211311121212211222222222121222221212111121111111221212122221211111111222121212222111121222222222222212212122222222222122212221121
111111211111221111222122222121222211222222222121211112122122222222212121112221121211222222112221211112122121222222222222212122122222222222121122112221
112222222221122221211221212122111221222222222121212222121122222222212122211121312211211112221112221112112221222222222222212121122222222222122121222111
112222222221121121221212212212221121222222222121212122122122222222212211222212222112222112212222122222221111222222222222212111122222222222121221211221
112222222221122122121112121211121121111111111122212112112122222222212222121222211222111221211111111112122211222222222222212222222222222222221211211211
112222222221212112121222121212122212222211111111212122222122222222212112222111212211222212212222222222111221222222222222212212122222222222121211222211
112222222221212212121211121212211222111212222222212111122122222222222121131111112122221112112222222222122121111111111211111122122222222222221222111221
112222222221222212222212221211221211222112222222212222111122222222212221112222212212121222112222222222112122122222221222212222111111111111121221211121
112222222221211111112111121221121211212112222222212112222122222222211222212111222222121212212222222222122112111212122211222112222122222211221121122221
112222222221212222222222122122121221212212222222212121112122222222212131212211111111111211212222222222121222221212111111111112111221121212212122121111
112222222222212222222222112112121122211212222222212122212122222222212211221211222222221211212222222222122211122112112222222222222212122122222112121221
111112211111212222222222112222222211122222222222212212212122222222212222121221222222221211212222222222111122212222112222222222221212212221111122121121
122112222221212222222222111111111111221212222222211212122111111111112122221121222222221222112222222222112221221111212222222222221211221112222221122221
112122111121222222222222112222222211211212222222211222121222221222111121111221222222221112112222222222122111122222212222222222221211122212112111311121
122121212221212222222222112222222211212212222222211122122212112212222122221211222222221222312222222222121122211121212222222222221222122112112122222121
121121212111212222222222112222222212212112222222212212211112222121112212111211222222221212111111112121122221211221212222222222221112112112221221221121
121122212122212222222222112222222212112212222222222121212221111121121221222211222222221221222212222222211212122212212222222222221222112121122212122121
122221112121111111111111112222222222221212222222212221212122222222221121211121222222221222211212111211111221221122112222222222221211122222111112112221
111121222121222222212112212222222211121211111111112212222111121111111121211121222222221211122212121211222212212222222222222222221212221212122222221111
111121211121211221212222212222222212122122222222221222212122222222221121222122222222221221221212221222211112122131211111111111111212211221221211122121
122211222122122211211121212222222222112221211111111111221122222222221121112221222222221121212212111121111112121111111111111111212212222111211222212121
121222112212222121221121212222222212211221212222222221121122222222221122112221111111111221211112122222222122111122222222222221212122112222222122122121
121112122121112122122121212222222212221122112222222221221122222222221212122112221122221111222222122222222221222122222222222221222121111121111112122221
122212221122221222212221211111111112122112212222222221212122222222221212221222122121122222122111122222222221212122222222222221112211222222222212211111
121221211222122211222111111111111122112221212222222221221122222222221222112211222122212212212112122222222121212122222222222221121221222222222212222211
122121122211121111111212222222222121122112212222222221121122222222221221222122112111122121212222122222222122212122222222222221221121222222222212111221
112122121112222222221212222222222111221222212222222221221122222222221212122112112111221121221122122222222111122122222222222221212221222222222212111121
112112221212222222221212222222222122212211212222222221212122222222221222121212112122212222121112122222222112222122222222222221212111222222222211222121
112211111212222222221212222222222121122121212222222222212122222222221112121222222221121212122212122222222222112222222222222221212121222222222222212121
121211221212222222221212222222222222121122211111111111222122222222221212122111111211112211111221122222222121222122222222222221222121222222222212112121
121222122212222222221212222222222112122211222111222222122111111111111222112222222222212112222121122222222121112122222222222221211121222222222212112221
122112121212222222221212222222222112112221112221211112112221221212122221122122222222212222112221111111111122221122222222222222222221222222222212111221
121212121212222222221212222222222222212122221121212112121122121212121112221122222222222121111111111112221222122111111211111111111221222222222212221121
121222111212222222221212222222222121221111122212212212122212121212221222112122222222212122222222122212121211212222222222222212211121222222222212122211
121221122222222222221212222222222121112222121112111212211222221221111211222122222222212122222222121222121221121111111121221222122221111111111112211211
122212221111111111111212222222222122222112122212122211222111222122111211221122222222212122222222122111121121221222222221211111221112112221122221221221
121111122211122222122211211111111111111222211222221222112111112212222211121122222222212122222222112122122121211222222222222222212222222121221121122121
122222121222212212121212222222222222222211111121111111112122221121111122223122222222212122222222122121212121221222222221111111111211211122111122222121
111112121221222122221222212111211111111111222222222222212121122221122221121122222222212122222222121122122121121222222221122222222221222212222111211221
121222121211211111211111212211222222222211222222222222212221111221121111122122222222212122222222122212121221121222222221122222222221211211112221212221
121211111221212222222221121211222222222211222222222222212211222121121222212122222222212122222222121112221212221222222221122222222221221222221121212121
121212221121112222222221221222222222222211222222222222222112221221121211222122222222212122222222122221111212122222222221122222222221122112212122112211
122212122122212222222221212121222222222211222222222222212212121211221212212111111111112111111112121122221222122222222221122222222222222221212212221221
121112112111222222222221211221222222222211222222222222211212121212211221121112222221122122112222121111121111121222222221122222222221212112212221121121
122212112111212222222221211211222222222211222222222222211222112212122122122222112121221221222112121222122212221222222221122222222222212122112121221121
111212122222222222222221222211222222222211222222222222212112212122112112122111222121211212211222121211111222111222222221122222222221221221122121212221
121212111112212222222221211111222222222211222222222222212211212221222122121222122121221212122112221222222111121222222221111111111111112212121121222121
121212222121212222222221212221222222222211111121111111111212211112212121221112121122121212212211112221112112221111111111222122222112222112121221111121
121221112121212222222222221121111111111112211122212222221212112221112121212222122211221211221222221111222212121122221222212112112122111222121211111121
122222222122211111111111122222222222222221222221222111122222222122222122222111211222211222222211122222211222122221122211122222122221222212221222222221
111111111111111111111111111111111111111111111111111111111111111111111111111111111111111111111111111111111111111111111111111111111111111111111111111111
