111111111111111111111111111111
112222221112222214122222222221
122122112222112122221211142124
141221222111222221112212222121
122241241111111114111112114421
121412211222222222222212422211
122222121222222222222242124211
121111241222222222222212224221
121222221222222222222212112121
121141121222222222222222122121
122222424222222222222212224221
111142122222222222222211112221
122112421222222222222212222121
112212224111111111111112111111
111214211411111411222222222224
122212212222222224111211111124
121122112222222221122222222124
124121212222222221122222222121
122222222222222224122222222121
121111142222222221122222222121
122122112222522221122222222124
142112112222222221122222222121
122112412222222221122222222121
121122142222222221122222222421
121121441111112111122222222124
121422222122212222222222222121
122221112121221122111111111121
111111222122422224222411222224
122222211212211222212222211221
111111111111111111111111111111
